,Lot Type,Lots Available,Lots Occupied,Total Lots,Update Date,Update Time,car_park_no
0,C,0,91,91,2019-10-18,10:54:53,HE12
1,C,119,464,583,2019-10-18,10:54:34,HLM
2,C,219,103,322,2019-10-18,10:54:53,RHM
3,C,1,96,97,2019-10-18,10:54:52,BM29
4,C,1,95,96,2019-10-18,10:54:36,Q81
5,C,1,172,173,2019-10-18,10:54:33,C20
6,C,103,125,228,2019-10-18,10:54:38,FR3M
7,C,214,75,289,2019-10-18,10:54:50,C32
8,C,177,155,332,2019-10-18,10:54:51,C6
9,C,150,123,273,2019-10-18,10:54:41,TG2
10,C,381,162,543,2019-10-18,10:54:38,BP1
11,C,99,34,133,2019-10-18,10:54:37,TG1
12,C,157,32,189,2019-10-18,10:54:42,TGM2
13,C,83,55,138,2019-10-18,10:54:33,TE14
14,C,0,48,48,2019-10-18,10:54:41,BM3
15,C,121,491,612,2018-12-17,07:42:34,BM9
16,C,24,156,180,2019-10-18,10:50:43,HG44
17,C,22,58,80,2019-10-18,10:50:57,HG64
18,C,206,102,308,2019-10-18,10:51:09,PM27
19,C,197,105,302,2019-10-18,10:51:10,PM28
20,C,139,82,221,2019-10-18,10:51:01,TM36
21,C,193,45,238,2019-10-18,10:50:44,TM37
22,C,240,122,362,2019-10-18,10:50:45,T50
23,C,190,161,351,2019-10-18,10:51:02,T51
24,C,207,42,249,2019-10-18,10:50:56,TM43
25,C,0,30,30,2019-10-18,10:51:04,T15
26,C,33,74,107,2019-10-18,10:51:07,T16
27,C,94,151,245,2019-10-18,10:51:06,T17
28,C,2,82,84,2019-10-18,10:51:08,T18
29,C,155,42,197,2019-10-18,10:50:57,B9
30,C,233,278,511,2019-10-18,10:50:47,B10
31,C,61,147,208,2018-10-29,09:18:49,B14
32,C,14,120,134,2019-10-18,10:54:05,WCB
33,C,2,94,96,2019-10-18,10:54:53,ACB
34,C,7,30,37,2019-10-18,10:54:53,CY
35,C,210,198,408,2019-10-18,10:55:38,AM46
36,C,168,37,205,2019-10-18,10:54:19,A12
37,C,304,59,363,2019-10-18,10:54:22,BE45
38,C,531,176,707,2019-10-18,10:54:23,BE39
39,C,201,138,339,2019-06-18,10:58:35,BE40
40,C,181,139,320,2017-03-31,12:00:21,RCB
41,C,0,56,56,2019-10-18,10:53:51,CR29
42,C,181,171,352,2019-10-18,10:53:51,KLM
43,C,175,95,270,2019-10-18,10:54:25,SE34
44,C,5,60,65,2019-10-18,10:54:08,KB7
45,C,147,48,195,2019-10-18,10:54:23,SE31
46,C,0,15,15,2019-10-18,10:52:37,J56
47,C,174,189,363,2019-10-18,10:54:12,J57
48,C,0,13,13,2019-10-18,10:54:12,J57L
49,C,74,37,111,2019-10-18,10:54:03,J33
50,C,83,22,105,2019-10-18,10:53:57,J34
51,C,202,298,500,2019-10-18,10:54:27,BL8
52,C,418,76,494,2019-10-18,10:54:29,J36
53,C,108,118,226,2019-10-18,10:54:10,J54
54,C,82,59,141,2019-10-18,10:53:45,J55
55,C,158,32,190,2019-10-18,10:53:28,J43
56,C,0,63,63,2019-10-18,10:54:07,J46
57,C,147,92,239,2019-10-18,10:54:16,KB1
58,C,631,46,677,2019-10-18,10:54:16,GBM
59,C,87,100,187,2019-10-18,10:54:36,SE14
60,C,515,76,591,2019-10-18,10:54:37,SE50
61,C,158,51,209,2019-10-18,10:54:25,J40
62,C,199,142,341,2019-10-18,10:54:14,JM1
63,C,152,36,188,2019-10-18,10:54:14,J32
64,C,203,165,368,2019-10-18,10:54:15,A11
65,C,213,170,383,2019-10-18,10:53:51,TR1
66,C,337,5,342,2019-10-18,10:54:47,JBM
67,C,196,17,213,2019-10-18,10:54:52,TE2
68,C,12,78,90,2019-10-18,10:54:24,CR31
69,C,302,66,368,2019-10-18,10:54:33,J1
70,C,160,40,200,2019-10-18,10:53:16,J2
71,C,241,67,308,2019-10-18,10:53:02,J3
72,C,778,396,1174,2019-10-18,10:50:56,T37
73,C,84,58,142,2019-10-18,10:54:12,KB3
74,C,195,42,237,2019-10-18,10:54:29,KBM
75,C,128,44,172,2019-10-18,10:53:37,J4
76,C,339,49,388,2019-10-18,10:54:54,TGM1
77,C,165,43,208,2019-10-18,10:54:51,TG3
78,C,145,31,176,2019-10-18,10:54:52,TG6
79,C,180,182,362,2019-10-18,10:54:52,TG7
80,C,10,33,43,2019-10-18,10:54:20,CR30
81,C,45,103,148,2019-10-18,10:54:20,RCM
82,C,64,222,286,2019-10-18,10:54:38,EPM
83,C,458,95,553,2019-10-18,10:54:38,TGM3
84,C,11,46,57,2019-10-18,10:54:26,KB14
85,C,289,61,350,2019-10-18,10:54:14,J41
86,C,108,36,144,2019-10-18,10:54:51,JBM2
87,C,196,54,250,2019-10-18,10:54:04,J39
88,C,334,116,450,2019-10-18,10:54:39,J52
89,C,408,42,450,2019-10-18,10:54:03,J51
90,C,186,29,215,2019-10-18,10:52:52,J53
91,C,433,433,866,2019-10-18,10:50:52,T19
92,C,182,23,205,2019-10-18,10:53:51,J49
93,C,239,78,317,2019-10-18,10:53:35,J27
94,C,9,34,43,2019-10-18,10:54:41,TB14
95,C,196,305,501,2019-10-18,10:54:45,U19
96,C,8,87,95,2019-10-18,10:53:24,U6
97,C,96,63,159,2019-10-18,10:53:56,U45
98,C,66,45,111,2019-10-18,10:54:09,BBM7
99,C,271,188,459,2019-10-18,10:54:15,BE12
100,C,285,190,475,2019-10-18,10:50:56,HG41
101,C,252,261,513,2019-10-18,10:50:54,HG43
102,C,256,51,307,2019-10-18,10:54:10,MN1
103,C,307,50,357,2019-10-18,10:53:50,MNRM
104,C,220,79,299,2019-10-18,10:54:42,MN2
105,C,178,270,448,2019-10-18,10:54:46,C7
106,C,4,30,34,2019-10-18,10:54:00,C17
107,C,437,114,551,2019-10-18,10:54:35,C20M
108,C,121,96,217,2019-10-18,10:50:44,T41
109,C,12,70,82,2019-10-18,10:51:09,T42
110,C,196,63,259,2019-10-18,10:50:50,TM42
111,C,418,163,581,2019-10-18,10:54:08,J48
112,C,0,57,57,2019-10-18,10:53:20,BH1
113,C,8,42,50,2019-10-18,10:54:21,BH2
114,C,129,43,172,2019-10-18,10:54:22,BKE7
115,C,79,71,150,2019-10-18,10:53:45,BR5
116,C,363,39,402,2019-10-18,10:53:28,BRM3
117,C,93,79,172,2019-10-18,10:53:01,BRM4
118,C,59,47,106,2019-10-18,10:54:35,M16
119,C,21,9,30,2019-10-18,10:54:33,M20
120,C,61,28,89,2019-10-18,10:53:38,M35
121,C,13,3,16,2019-10-18,10:53:35,M36
122,C,25,9,34,2019-10-18,10:53:54,M37
123,C,12,21,33,2019-10-18,10:54:35,M38
124,C,176,38,214,2019-10-18,10:52:41,MM3
125,C,160,60,220,2019-10-18,10:54:42,MP12
126,C,211,185,396,2019-10-18,10:54:42,MP13
127,C,456,66,522,2019-10-18,10:53:51,MP1M
128,C,159,98,257,2019-10-18,10:53:56,PP1
129,C,98,47,145,2019-10-18,10:54:03,PP2
130,C,271,103,374,2019-10-18,10:54:18,PP3
131,C,102,64,166,2019-10-18,10:54:13,PP4
132,C,228,118,346,2019-10-18,10:54:39,PP5
133,C,71,39,110,2019-10-18,10:54:23,TP10
134,C,31,20,51,2019-10-18,10:54:27,TP14
135,C,330,338,668,2019-10-18,10:54:37,TP16
136,C,53,66,119,2019-10-18,10:53:53,TP17
137,C,206,177,383,2019-10-18,10:54:04,TP18
138,C,40,37,77,2019-10-18,10:54:18,TP2
139,C,22,59,81,2019-10-18,10:53:42,TPMG
140,C,150,97,247,2019-10-18,10:54:18,TP36
141,C,246,95,341,2019-10-18,10:54:18,TPM4
142,C,42,298,340,2019-10-18,10:54:18,TPM5
143,C,273,85,358,2019-10-18,10:53:49,TPM6
144,C,52,160,212,2019-10-18,10:53:42,TP27
145,C,495,150,645,2019-10-18,10:53:52,TPMN
146,C,638,171,809,2019-10-18,10:53:18,TPMP
147,C,47,23,70,2019-10-18,10:51:21,WDB1
148,C,638,185,823,2019-10-18,10:54:38,Y23
149,C,122,59,181,2019-10-18,10:54:39,Y24
150,C,15,32,47,2019-10-18,10:54:35,Y56
151,C,380,26,406,2019-10-18,10:53:10,BBM1
152,C,235,65,300,2019-10-18,10:53:59,BBM8
153,C,243,67,310,2019-10-18,10:54:05,BJ10
154,C,86,14,100,2019-10-18,10:54:21,BJ11
155,C,546,54,600,2019-10-18,10:54:14,BJ12
156,C,167,5,172,2019-10-18,10:54:07,BJ17
157,C,275,49,324,2019-10-18,10:54:07,BJ18
158,C,564,105,669,2019-10-18,10:53:47,BJ28
159,C,847,207,1054,2019-10-18,10:54:52,BJ3
160,C,349,17,366,2019-10-18,10:54:05,BJ33
161,C,353,97,450,2019-10-18,10:54:37,BJ42
162,C,208,24,232,2019-10-18,10:52:36,BJ45
163,C,131,61,192,2019-10-18,10:53:49,CK21
164,C,83,10,93,2019-10-18,10:53:54,U48
165,C,27,12,39,2019-10-18,10:52:13,U5
166,C,431,59,490,2019-10-18,10:55:47,JM14
167,C,295,173,468,2019-10-18,10:55:43,JM12
168,C,138,88,226,2019-10-18,10:54:37,W39
169,C,405,330,735,2019-10-18,10:53:47,PL67
170,C,19,981,1000,2017-12-04,10:54:50,W2
171,C,53,947,1000,2017-12-04,10:54:50,W1
172,C,293,107,400,2019-10-18,10:53:48,U9
173,C,500,151,651,2019-10-18,10:53:31,U26
174,C,477,148,625,2019-10-18,10:53:53,U25
175,C,43,7,50,2019-10-18,10:53:48,U24T
176,C,325,72,397,2019-10-18,10:53:48,U24
177,C,579,171,750,2019-10-18,10:53:50,U23
178,C,251,49,300,2019-10-18,10:53:55,U22
179,C,144,56,200,2019-10-18,10:53:55,U21
180,C,781,328,1109,2019-10-18,10:53:52,U2
181,C,287,66,353,2019-10-18,10:54:29,J45
182,C,86,41,127,2019-10-18,10:51:08,TM25
183,C,74,52,126,2019-10-18,10:51:06,TM26
184,C,208,29,237,2019-10-18,10:50:50,TM27
185,C,167,83,250,2019-10-18,10:53:50,J37
186,C,10,50,60,2019-10-18,10:54:43,BM1
187,C,0,53,53,2019-10-18,10:54:43,BM2
188,C,271,189,460,2019-10-18,10:54:55,BM26
189,C,94,126,220,2019-10-18,10:54:56,BWM
190,C,0,156,156,2019-10-18,10:51:10,TBMT
191,C,142,241,383,2019-10-18,10:54:44,TPM
192,C,183,155,338,2019-10-18,10:55:40,U29
193,C,3,17,20,2019-10-18,10:55:38,U27
194,C,124,376,500,2019-10-18,10:56:00,U18
195,C,78,57,135,2019-10-18,10:54:11,U30
196,C,0,25,25,2015-12-30,10:38:36,EPML
197,C,100,198,298,2019-10-18,10:54:47,TE25
198,C,0,19,19,2019-10-18,10:54:52,TE3
199,C,0,30,30,2019-10-18,10:54:48,TE4
200,C,0,15,15,2019-10-18,10:55:46,U28
201,C,3,56,59,2019-10-18,10:54:15,A15
202,C,0,47,47,2019-10-18,10:53:55,BM28
203,C,38,8,46,2019-10-18,10:54:00,BM30
204,C,84,208,292,2019-10-18,10:54:01,BTM
205,C,252,244,496,2019-10-18,10:53:56,BTM2
206,C,78,258,336,2019-10-18,10:54:01,SAM2
207,C,48,195,243,2019-10-18,10:53:58,TBM2
208,C,249,101,350,2019-10-18,10:55:50,TJ34
209,C,131,115,246,2019-10-18,10:54:20,U31
210,C,187,212,399,2019-10-18,10:53:55,BL13
211,C,40,206,246,2019-10-18,10:54:04,HG10
212,C,217,783,1000,2018-12-20,03:59:43,W3
213,C,158,69,227,2019-10-18,10:50:42,BJ65
214,C,33,35,68,2019-10-18,10:50:42,CK19
215,C,3,3,6,2019-10-18,10:50:51,CK4
216,C,675,247,922,2019-10-18,10:50:40,CK42
217,C,99,207,306,2019-10-18,10:50:40,CK7
218,C,56,52,108,2019-10-18,10:50:33,TW1
219,C,199,156,355,2019-10-18,10:50:53,TW2
220,C,158,180,338,2019-10-18,10:50:35,TW3
221,C,286,67,353,2016-02-04,18:15:45,BL18M
222,C,209,139,348,2019-10-18,10:54:43,B16
223,C,140,252,392,2019-10-18,10:55:05,B17
224,C,146,234,380,2019-10-18,10:54:14,B20
225,C,32,89,121,2019-10-18,10:54:21,B42
226,C,0,68,68,2019-10-18,10:54:24,B45
227,C,0,513,513,2019-10-18,10:54:54,B6
228,C,21,79,100,2019-10-18,10:54:19,B63
229,C,574,169,743,2019-10-18,10:54:48,B65
230,C,16,70,86,2019-10-18,10:54:56,B7
231,C,18,21,39,2019-10-18,10:55:00,B70
232,C,162,74,236,2019-10-18,10:54:48,B71
233,C,0,129,129,2019-10-18,10:54:48,B7A
234,C,45,60,105,2019-10-18,10:55:00,B8
235,C,221,26,247,2019-10-18,10:54:27,B80
236,C,496,55,551,2019-10-18,10:54:48,B84
237,C,120,0,120,2015-03-03,05:02:19,B88M
238,C,75,0,75,2015-03-03,05:02:19,B90
239,C,75,0,75,2015-03-03,05:02:19,B90M
240,C,48,66,114,2019-10-18,10:54:08,CC5
241,C,0,57,57,2019-10-18,10:54:48,CC6
242,C,186,155,341,2019-10-18,10:54:21,B30
243,C,309,105,414,2019-10-18,10:54:21,B31
244,C,0,20,20,2019-10-18,10:54:27,TJ28
245,C,458,0,458,2019-10-18,10:53:49,TJ31
246,C,383,1,384,2019-10-18,10:53:49,TJ37
247,C,829,13,842,2018-08-28,17:22:10,TJSF
248,C,100,15,115,2019-10-18,10:55:36,AM16
249,C,53,38,91,2019-10-18,10:55:52,AM32
250,C,378,86,464,2019-10-18,10:50:57,BJ2
251,C,578,12,590,2019-10-18,10:50:49,CK48
252,C,267,83,350,2019-10-18,10:54:41,BE8
253,C,59,141,200,2019-10-18,10:54:20,SE11
254,C,362,192,554,2019-10-18,10:54:16,SE20
255,C,0,29,29,2019-10-18,10:54:40,SE21
256,C,0,20,20,2019-10-18,10:54:42,SE22
257,C,119,73,192,2019-10-18,10:54:40,SE23
258,C,37,127,164,2019-10-18,10:54:14,SE24
259,C,296,34,330,2019-10-18,10:54:51,SE53
260,C,0,19,19,2016-04-25,17:56:45,SM9A
261,C,2,26,28,2016-04-25,17:56:46,SM9B
262,C,43,45,88,2019-10-18,10:54:16,FR4M
263,C,66,24,90,2019-10-18,10:50:59,BJ31
264,C,10451,509,10960,2019-10-18,10:50:44,BJ32
265,C,92,50,142,2019-10-18,10:50:33,BJ34
266,C,75,69,144,2019-10-18,10:50:37,BJ35
267,C,101,43,144,2019-10-18,10:51:01,BJ36
268,C,869,1165,2034,2019-10-18,10:50:40,BJ37
269,C,0,53,53,2019-10-18,10:54:48,TP31
270,C,152,66,218,2019-10-18,10:50:43,BJ38
271,C,651,478,1129,2019-10-18,10:50:56,BJ39
272,C,534,55,589,2019-10-18,10:50:45,BJ40
273,C,10551,151,10702,2019-10-18,10:50:58,CK38
274,C,595,347,942,2019-10-18,10:55:41,A38
275,C,12,146,158,2019-10-18,10:55:47,A43
276,C,602,92,694,2019-10-18,10:50:50,CK8
277,C,254,122,376,2019-10-18,10:50:35,CK8A
278,C,818,187,1005,2019-10-18,10:50:57,CK39
279,C,702,172,874,2019-10-18,10:50:36,CK41
280,C,204,107,311,2019-10-18,10:50:53,CK46
281,C,100,595,695,2019-10-18,10:50:56,CK47
282,C,318,82,400,2019-10-18,10:55:27,SE32
283,C,183,123,306,2019-10-18,10:55:46,SE33
284,C,177,29,206,2019-10-18,10:55:41,SE39
285,C,9985,1019,11004,2019-10-18,10:50:41,BJ43
286,C,531,225,756,2019-10-18,10:50:42,CK22
287,C,10777,35,10812,2019-10-18,10:50:38,CK36
288,C,874,718,1592,2019-10-18,10:50:42,CK37
289,C,436,78,514,2019-10-18,10:55:38,A25
290,C,96,55,151,2019-10-18,10:55:30,A81
291,C,93,122,215,2019-10-18,10:55:54,A82
292,C,37,121,158,2019-10-18,10:55:43,A9
293,C,43,65,108,2019-10-18,10:55:50,A98
294,C,530,343,873,2019-10-18,10:50:35,BJ55
295,C,386,171,557,2019-10-18,10:51:01,BJ56
296,C,1465,123,1588,2019-10-18,10:50:57,CK44
297,C,255,1343,1598,2019-10-18,10:50:58,CK45
298,C,112,44,156,2019-10-18,10:55:55,SE35
299,C,103,347,450,2019-10-18,10:55:54,SE38
300,C,467,365,832,2019-10-18,10:55:38,SE40
301,C,10327,881,11208,2019-10-18,10:50:37,BJ30
302,C,226,84,310,2019-10-18,10:50:54,CK16
303,C,252,1512,1764,2019-10-18,10:50:46,CK49
304,C,268,106,374,2019-10-18,10:50:55,CK50
305,C,104,12,116,2019-10-18,10:50:54,CKT1
306,C,1308,1637,2945,2019-10-18,10:50:52,CK51
307,C,125,78,203,2019-10-18,10:50:32,CK12
308,C,288,35,323,2019-10-18,10:50:49,CK13
309,C,129,54,183,2019-10-18,10:50:32,CK17
310,C,132,12,144,2019-10-18,10:50:43,CK30
311,C,389,203,592,2019-10-18,10:50:52,CK31
312,C,10654,132,10786,2019-10-18,10:50:48,BJ41
313,C,135,60,195,2019-10-18,10:50:45,CK20
314,C,158,74,232,2019-10-18,10:50:41,CK23
315,C,196,452,648,2019-10-18,10:50:58,CK34
316,C,555,126,681,2019-10-18,10:50:48,CKM1
317,C,388,84,472,2019-10-18,10:50:59,BJ1
318,C,1174,821,1995,2019-10-18,10:50:51,BJ48
319,C,10399,73,10472,2019-10-18,10:50:38,CK33
320,C,53,142,195,2019-10-18,10:55:53,A37
321,C,223,39,262,2019-10-18,10:55:28,A39
322,C,115,27,142,2019-10-18,10:55:53,A68
323,C,20,114,134,2019-10-18,10:55:36,A70
324,C,44,141,185,2019-10-18,10:55:37,A71
325,C,1332,338,1670,2019-10-18,10:50:38,CK40
326,C,64,353,417,2019-10-18,10:55:29,A40
327,C,74,77,151,2019-10-18,10:55:49,A66
328,C,339,136,475,2019-10-18,10:55:36,A69
329,C,0,12,12,2019-10-18,10:55:52,A30
330,C,44,161,205,2019-10-18,10:55:40,AM80
331,C,109,121,230,2019-10-18,10:55:29,AM81
332,C,238,134,372,2019-10-18,10:54:47,CC7
333,C,291,97,388,2019-10-18,10:54:43,B88
334,C,252,1,253,2016-03-09,15:26:24,B71M
335,C,473,83,556,2019-10-18,10:54:11,B66
336,C,140,51,191,2019-10-18,10:54:47,B53
337,C,230,69,299,2019-10-18,10:54:47,B52
338,C,216,69,285,2019-10-18,10:54:47,B51
339,C,15,49,64,2015-08-19,13:50:02,B45B
340,C,14,61,75,2015-08-19,13:50:01,B45A
341,C,140,57,197,2019-10-18,10:54:48,B35
342,C,241,46,287,2019-10-18,10:54:48,B34
343,C,99,30,129,2019-10-18,10:54:49,B33
344,C,87,27,114,2019-10-18,10:54:49,B32
345,C,0,50,50,2019-10-18,10:54:32,KB17
346,C,0,164,164,2019-10-18,10:54:42,KB10
347,C,102,110,212,2019-10-18,10:54:42,KB11
348,C,41,23,64,2019-10-18,10:54:31,SD9
349,C,249,20,269,2019-10-18,10:49:29,W54
350,C,329,234,563,2019-10-18,10:54:37,BE23
351,C,275,90,365,2019-10-18,10:53:16,Y52M
352,C,189,70,259,2019-10-18,10:54:43,Y9
353,C,14,46,60,2019-10-18,10:54:06,Y20
354,C,894,300,1194,2019-10-18,10:54:48,Y10
355,C,241,110,351,2019-10-18,10:53:45,PM30
356,C,255,150,405,2019-10-18,10:53:22,PM3
357,C,10343,655,10998,2019-10-18,10:50:42,TWM3
358,C,818,454,1272,2019-10-18,10:50:43,CK61
359,C,532,786,1318,2019-10-18,10:50:37,CK60
360,C,297,87,384,2019-10-18,10:51:45,SK91
361,C,118,49,167,2019-10-18,10:56:00,SK75
362,C,141,84,225,2019-10-18,10:56:05,SK74
363,C,217,152,369,2019-10-18,10:55:41,SK88
364,C,158,79,237,2019-10-18,10:53:21,SK71
365,C,262,56,318,2019-10-18,10:50:10,SK43
366,C,131,33,164,2019-10-18,10:50:41,SK70
367,C,239,59,298,2019-10-18,10:52:52,SK92
368,C,230,124,354,2019-10-18,10:55:50,SK80
369,C,151,50,201,2019-10-18,10:50:27,SK72
370,C,174,44,218,2019-10-18,10:50:27,SK73
371,C,70,25,95,2019-10-18,10:51:00,SK83
372,C,178,196,374,2019-10-18,10:56:00,SK86
373,C,186,78,264,2019-10-18,10:56:05,SK78
374,C,164,73,237,2019-10-18,10:52:40,SK68
375,C,569,137,706,2019-10-18,10:53:24,SK3
376,C,426,103,529,2019-10-18,10:53:07,SK58
377,C,569,77,646,2019-10-18,10:53:07,SK62
378,C,71,44,115,2019-10-18,10:51:52,SK87
379,C,247,270,517,2019-10-18,10:51:00,CK3A
380,C,220,115,335,2019-10-18,10:50:40,CK3
381,C,343,24,367,2019-10-18,10:50:40,CK55
382,C,16,4,20,2019-10-18,10:50:33,CK29
383,C,204,36,240,2019-10-18,10:51:01,CK28
384,C,420,43,463,2019-10-18,10:55:55,AM22
385,C,578,28,606,2019-10-18,10:55:35,AM20
386,C,411,43,454,2019-10-18,10:55:36,AM18
387,C,131,119,250,2019-10-18,10:55:30,A20
388,C,62,27,89,2019-10-18,10:55:53,A65
389,C,399,98,497,2019-10-18,10:55:50,A60
390,C,115,80,195,2019-10-18,10:55:28,A50
391,C,104,26,130,2019-10-18,10:53:51,HG22
392,C,116,62,178,2019-10-18,10:50:56,CK25
393,C,21,17,38,2019-10-18,10:50:58,CK24
394,C,150,92,242,2019-10-18,10:54:03,STAM
395,C,183,296,479,2019-10-18,10:55:43,AM79
396,C,146,70,216,2019-10-18,10:55:56,A34
397,C,790,502,1292,2019-10-18,10:55:29,AM96
398,C,40,49,89,2019-10-18,10:55:32,A85
399,C,253,105,358,2019-10-18,10:55:32,A72
400,C,277,328,605,2019-10-18,10:55:37,A67
401,C,0,1052,1052,2018-11-30,11:23:35,JMSU
402,C,443,201,644,2018-11-30,11:26:13,JMSC
403,C,161,200,361,2019-10-18,10:55:57,BMVM
404,C,102,46,148,2019-10-18,10:54:08,HE3
405,C,11,40,51,2019-10-18,10:54:07,TB2
406,C,265,95,360,2019-10-18,10:54:10,JKM
407,C,30,12,42,2019-10-18,10:54:10,JKS
408,C,351,368,719,2019-10-18,10:53:55,SPM
409,C,121,194,315,2019-10-18,10:54:04,FR2C
410,C,152,262,414,2019-10-18,10:54:00,GM1A
411,C,243,176,419,2019-10-18,10:53:55,AR5M
412,C,0,64,64,2019-10-18,10:53:55,AR9
413,C,155,324,479,2019-10-18,10:53:58,C5
414,C,120,196,316,2019-10-18,10:54:04,C9
415,C,130,111,241,2019-10-18,10:55:45,U46
416,C,150,269,419,2019-10-18,10:55:51,U15
417,C,35,124,159,2019-10-18,10:55:51,U3
418,C,97,31,128,2019-10-18,10:55:41,U32
419,C,324,1,325,2019-10-18,10:54:47,B75
420,C,82,38,120,2019-10-18,10:53:10,U38
421,C,162,52,214,2019-10-18,10:54:02,U10
422,C,298,49,347,2019-10-18,10:54:51,C8
423,C,373,170,543,2019-10-18,10:55:18,J60M
424,C,523,55,578,2019-10-18,10:55:18,J38
425,C,178,165,343,2019-10-18,10:55:25,UBKM
426,C,0,287,287,2019-10-18,10:55:25,UBK2
427,C,135,11,146,2019-10-18,10:54:42,UBK5
428,C,45,31,76,2016-02-15,15:12:52,HE8
429,C,197,230,427,2019-10-18,10:55:42,U17
430,C,235,24,259,2019-10-18,10:55:42,U4
431,C,255,245,500,2019-10-18,10:56:00,U1
432,C,1,3,4,2019-10-18,10:54:53,TGML
433,C,2,10,12,2019-10-18,10:54:10,BRBL
434,C,194,207,401,2019-10-18,10:56:03,BL18
435,C,0,170,170,2019-10-18,10:54:10,BRB1
436,C,509,270,779,2019-10-18,10:55:59,J61
437,C,423,271,694,2019-10-18,10:55:39,J73
438,C,241,126,367,2019-10-18,10:56:01,J74
439,C,93,155,248,2019-10-18,10:56:01,U39
440,C,121,167,288,2019-10-18,10:55:53,U40
441,C,0,28,28,2019-10-18,10:55:46,U41
442,C,183,699,882,2019-10-18,10:53:54,C3M
443,C,124,268,392,2019-10-18,10:53:55,C4M
444,C,106,41,147,2019-10-18,10:55:35,J70
445,C,213,120,333,2019-10-18,10:55:39,J75M
446,C,323,168,491,2019-10-18,10:56:03,JM15
447,C,328,232,560,2019-10-18,10:55:36,JM18
448,C,321,224,545,2019-10-18,10:54:15,C24
449,C,0,17,17,2019-10-18,10:54:12,C27
450,C,169,343,512,2019-10-18,10:54:02,KTM5
451,C,248,4,252,2019-08-01,08:03:57,KTM6
452,C,274,192,466,2019-10-18,10:54:39,BP2
453,C,628,586,1214,2019-10-18,10:55:54,BBM3
454,C,587,364,951,2019-10-18,10:55:35,BBM5
455,C,164,126,290,2019-10-18,10:55:47,U33
456,C,165,138,303,2019-10-18,10:56:05,U34
457,C,169,116,285,2019-10-18,10:55:58,J84M
458,C,180,89,269,2019-10-18,10:55:40,J85M
459,C,62,198,260,2019-10-18,10:54:05,Q84
460,C,225,197,422,2019-10-18,10:54:05,Q87
461,C,251,190,441,2019-10-18,10:54:05,Q89
462,C,1,45,46,2019-10-18,10:54:03,BM5
463,C,6,52,58,2019-10-18,10:50:52,TB1
464,C,27,127,154,2019-10-18,10:54:07,TB3
465,C,29,48,77,2019-10-18,10:38:50,TB9
466,C,50,56,106,2019-10-18,10:53:52,TBC3
467,C,0,35,35,2019-10-18,10:54:03,C26
468,C,91,53,144,2019-10-18,10:54:07,C25
469,C,146,54,200,2019-10-18,10:54:02,C22M
470,C,684,3,687,2019-10-18,10:54:51,JM7
471,C,0,706,706,2019-10-18,10:54:57,JM30
472,C,188,67,255,2019-10-18,10:54:56,J72
473,C,153,69,222,2019-10-18,10:55:00,J69
474,C,501,292,793,2019-10-18,10:54:59,JM23
475,C,1431,6,1437,2019-10-18,10:54:59,JM19
476,C,211,59,270,2019-10-18,10:53:58,U43
477,C,85,915,1000,2019-07-03,03:59:43,U43Z
478,C,390,163,553,2019-10-18,10:54:37,W21
479,C,350,207,557,2019-10-18,10:54:25,W24
480,C,306,111,417,2019-10-18,10:54:23,M25
481,C,86,36,122,2019-10-18,10:53:40,M3
482,C,320,133,453,2019-10-18,10:53:48,M4
483,C,153,24,177,2019-10-18,10:53:40,MM1
484,C,80,282,362,2019-10-18,10:54:23,MM2
485,C,276,9,285,2019-10-18,10:53:40,MM4
486,C,38,30,68,2019-10-18,10:52:52,UA2
487,C,205,35,240,2019-10-18,10:52:31,UA3
488,C,302,32,334,2019-10-18,10:53:57,UA5
489,C,179,276,455,2019-10-18,10:52:52,UAM1
490,C,59,129,188,2019-10-18,10:55:44,JM31
491,C,1465,190,1655,2019-10-18,10:54:19,BBM9
492,C,370,14,384,2019-10-18,10:54:03,C21M
493,C,466,195,661,2019-10-18,10:54:08,U13
494,C,235,55,290,2019-10-18,10:54:11,C13M
495,C,211,105,316,2019-10-18,10:54:25,C12
496,C,126,85,211,2019-10-18,10:54:11,C14M
497,C,215,537,752,2019-10-18,10:54:18,C10
498,C,175,59,234,2019-10-18,10:55:00,BL10
499,C,371,0,371,2019-10-18,10:55:05,BL19
500,C,138,58,196,2019-10-18,10:54:56,BL3
501,C,344,118,462,2019-10-18,10:54:33,J50
502,C,10,0,10,2019-10-18,10:55:18,J60L
503,C,296,129,425,2019-10-18,10:54:43,J62
504,C,109,113,222,2019-10-18,10:54:43,J62M
505,C,90,63,153,2019-10-18,10:54:43,J63
506,C,767,208,975,2019-10-18,10:54:57,J65
507,C,297,184,481,2019-10-18,10:55:04,J71
508,C,374,3,377,2019-10-18,10:55:04,J76M
509,C,191,0,191,2019-10-18,10:54:57,J77M
510,C,484,0,484,2019-10-18,10:55:05,J78M
511,C,469,1,470,2019-10-18,10:55:04,J79M
512,C,444,5,449,2019-10-18,10:54:58,J80M
513,C,425,6,431,2019-10-18,10:55:04,J81M
514,C,38,497,535,2019-10-18,10:55:18,J82M
515,C,62,59,121,2019-10-18,10:56:04,J83M
516,C,106,88,194,2019-10-18,10:55:00,J86M
517,C,601,2,603,2019-10-18,10:54:33,J88M
518,C,590,1,591,2019-10-18,10:54:33,J89M
519,C,180,204,384,2019-10-18,10:54:46,J98M
520,C,425,79,504,2019-10-18,10:54:47,J99M
521,C,196,224,420,2019-10-18,10:54:46,JM10
522,C,0,1044,1044,2019-10-18,10:55:06,JM13
523,C,532,0,532,2019-10-18,10:54:25,JM22
524,C,490,1,491,2019-10-18,10:54:25,JM25
525,C,260,386,646,2019-10-18,10:54:21,JM28
526,C,201,440,641,2019-10-18,10:54:22,JM29
527,C,281,79,360,2019-10-18,10:50:20,TBM3
528,C,508,1,509,2019-10-18,10:50:11,TBM4
529,C,23718,725,24443,2019-10-18,10:50:55,BJ49
530,C,476,186,662,2019-10-18,10:54:50,Y11
531,C,424,273,697,2019-10-18,10:54:35,Y8
532,C,180,68,248,2019-10-18,10:54:26,Y13
533,C,292,111,403,2019-10-18,10:54:39,Y3
534,C,122,53,175,2019-10-18,10:54:39,Y3M
535,C,130,61,191,2019-10-18,10:54:20,Y39
536,C,21,10,31,2019-10-18,10:54:20,MPS
537,C,369,122,491,2019-10-18,10:54:25,Y48
538,C,276,17,293,2019-10-18,10:54:25,Y48M
539,C,213,118,331,2019-10-18,10:53:03,Y15
540,C,532,278,810,2019-10-18,10:55:00,Y4
541,C,215,71,286,2019-10-18,10:54:54,Y27
542,C,369,197,566,2019-10-18,10:55:01,Y49
543,C,267,91,358,2019-10-18,10:54:31,Y21M
544,C,126,159,285,2019-10-18,10:55:23,Y28
545,C,245,61,306,2019-10-18,10:54:41,Y28M
546,C,63,39,102,2019-10-18,10:54:56,Y33
547,C,174,105,279,2019-10-18,10:54:36,Y49M
548,C,17,10,27,2019-10-18,10:54:36,Y49L
549,C,28,-25,3,2016-02-15,21:52:35,Y49HV
550,C,390,257,647,2019-10-18,10:54:23,Y7
551,C,0,21,21,2019-10-18,10:54:12,Y57
552,C,1,45,46,2019-10-18,10:54:10,Y21
553,C,334,55,389,2019-10-18,10:54:10,SB19
554,C,330,57,387,2019-10-18,10:54:10,SB24
555,C,3,1,4,2019-10-18,10:54:10,S19L
556,C,2,0,2,2019-10-18,10:54:10,S24L
557,C,298,12,310,2019-10-18,10:54:47,SB2
558,C,510,83,593,2019-10-18,10:53:55,SB16
559,C,359,57,416,2019-10-18,10:54:21,SB26
560,C,371,24,395,2019-10-18,10:54:21,SB27
561,C,427,71,498,2019-10-18,10:54:21,SB28
562,C,8,0,8,2016-02-25,22:52:35,SB28L
563,C,307,56,363,2019-10-18,10:54:13,SB3
564,C,1417,112,1529,2019-10-18,10:54:12,SB15
565,C,10,5,15,2019-10-18,10:54:12,S15L
566,C,210,60,270,2019-10-18,10:53:47,SB4
567,C,306,44,350,2019-10-18,10:54:25,SB5
568,C,609,35,644,2019-10-18,10:54:45,SB18
569,C,770,32,802,2019-10-18,10:54:45,SB21
570,C,420,92,512,2019-10-18,10:53:59,SB29
571,C,377,38,415,2019-10-18,10:54:15,SB30
572,C,155,35,190,2019-10-18,10:54:15,SB31
573,C,428,124,552,2019-10-18,10:54:14,SB23
574,C,450,80,530,2019-10-18,10:54:30,SB22
575,C,47,14,61,2019-10-18,10:53:00,SB34
576,C,317,16,333,2019-10-18,10:53:58,SK36
577,C,486,52,538,2019-10-18,10:53:58,SK37
578,C,390,75,465,2019-10-18,10:53:58,SK42
579,C,567,105,672,2019-10-18,10:50:32,SK23
580,C,294,100,394,2019-10-18,10:52:55,SK10
581,C,249,77,326,2019-10-18,10:53:11,SK19
582,C,231,52,283,2019-10-18,10:53:11,SK20
583,C,263,99,362,2019-10-18,10:50:34,SK11
584,C,479,77,556,2019-10-18,10:52:39,SK45
585,C,504,89,593,2019-10-18,10:53:56,SK4
586,C,348,66,414,2019-10-18,10:53:59,SK77
587,C,337,92,429,2019-10-18,10:53:59,SK16
588,C,399,95,494,2019-10-18,10:52:14,SK63
589,C,470,69,539,2019-10-18,10:52:15,SK7
590,C,9,29,38,2019-10-18,10:54:30,MR4
591,C,69,87,156,2019-10-18,10:54:44,CR7
592,C,289,113,402,2019-10-18,10:54:35,KB4
593,C,122,148,270,2019-10-18,10:54:51,JRM
594,C,14,50,64,2019-10-18,10:55:11,SD5
595,C,15,176,191,2019-10-18,10:54:38,KB12
596,C,31,18,49,2019-10-18,10:54:15,UBK4
597,C,0,27,27,2019-10-18,10:54:44,SD2
598,C,54,80,134,2019-10-18,10:54:44,SDM2
599,C,94,-56,38,2016-02-15,21:52:35,MR567
600,C,102,39,141,2019-10-18,10:55:10,SG3
601,C,256,139,395,2019-10-18,10:54:23,NBRM
602,C,89,12,101,2019-10-18,10:55:16,SG2
603,C,174,19,193,2019-10-18,10:53:36,SDM
604,C,0,101,101,2019-10-18,10:54:59,SD3
605,C,45,4,49,2019-10-18,10:52:50,W107
606,C,64,221,285,2019-10-18,10:53:58,W30
607,C,0,10,10,2019-10-18,10:53:58,W28
608,C,245,69,314,2019-10-18,10:51:50,W44
609,C,291,17,308,2019-10-18,10:52:44,W45
610,C,0,121,121,2019-10-18,10:52:56,W7
611,C,178,22,200,2019-10-18,10:53:55,W19
612,C,313,37,350,2019-10-18,10:52:48,W780
613,C,464,22,486,2019-10-18,10:53:50,W101
614,C,248,35,283,2019-10-18,10:53:48,W13
615,C,269,29,298,2019-10-18,10:52:42,W48
616,C,438,13,451,2019-10-18,10:53:49,W102
617,C,33,17,50,2019-10-18,10:53:21,W37
618,C,202,83,285,2019-10-18,10:52:58,W52
619,C,343,9,352,2019-10-18,10:52:50,W64
620,C,397,14,411,2019-10-18,10:53:59,W17
621,C,280,253,533,2019-10-18,10:53:31,W18
622,C,366,16,382,2019-10-18,10:51:10,W58
623,C,202,8,210,2019-10-18,10:52:33,W5
624,C,178,39,217,2019-10-18,10:52:33,W5M
625,C,384,166,550,2019-10-18,10:53:40,W23
626,C,274,30,304,2019-10-18,10:53:45,W40
627,C,262,13,275,2019-10-18,10:52:42,W49
628,C,224,30,254,2019-10-18,10:52:42,W50
629,C,285,19,304,2019-10-18,10:52:42,W51
630,C,412,127,539,2019-10-18,10:53:50,W36
631,C,106,10,116,2019-10-18,10:53:50,W10
632,C,21,34,55,2019-10-18,10:52:38,W6
633,C,202,73,275,2019-10-18,10:52:51,W181
634,C,210,120,330,2019-10-18,10:53:22,W14
635,C,368,67,435,2019-10-18,10:52:52,PM6
636,C,258,149,407,2019-10-18,10:53:47,PM17
637,C,344,99,443,2019-10-18,10:53:58,PM14
638,C,328,87,415,2019-10-18,10:52:41,PM29
639,C,188,68,256,2019-10-18,10:52:59,PM16
640,C,117,59,176,2019-10-18,10:53:06,PM18
641,C,83,69,152,2019-10-18,10:53:41,PM11
642,C,111,137,248,2019-10-18,10:52:56,PM7
643,C,286,155,441,2019-10-18,10:53:46,PM13
644,C,420,101,521,2019-10-18,10:53:36,PM45
645,C,289,78,367,2019-10-18,10:52:44,PM41
646,C,169,121,290,2019-10-18,10:53:21,PR1
647,C,368,73,441,2019-10-18,10:53:21,PM19
648,C,6,-4,2,2016-02-15,21:52:35,P40L1
649,C,6,-3,3,2016-02-15,21:52:35,P40L2
650,C,182,81,263,2019-10-18,10:54:14,PM40
651,C,229,64,293,2019-10-18,10:54:12,PM37
652,C,281,98,379,2019-10-18,10:54:12,PM36
653,C,402,71,473,2019-10-18,10:50:36,SK93
654,C,306,54,360,2019-10-18,10:53:18,SK2
655,C,729,136,865,2019-10-18,10:53:47,SK60
656,C,620,61,681,2019-10-18,10:53:34,SK15
657,C,621,56,677,2019-10-18,10:53:34,SK17
658,C,279,75,354,2019-10-18,10:50:57,SK12
659,C,0,28,28,2019-10-18,10:53:39,W4
660,C,436,71,507,2019-10-18,10:52:53,SK22
661,C,553,100,653,2019-10-18,10:53:57,SK21
662,C,268,87,355,2019-10-18,10:50:25,SK13
663,C,417,56,473,2019-10-18,10:50:25,SK6
664,C,1227,837,2064,2019-10-18,10:50:51,CK52
665,C,226,86,312,2019-10-18,10:53:54,P1
666,C,211,79,290,2019-10-18,10:53:54,P2
667,C,459,193,652,2019-10-18,10:53:43,P3
668,C,405,5,410,2019-10-18,10:53:44,P4
669,C,375,132,507,2019-10-18,10:54:30,P5
670,C,0,4,4,2019-10-18,10:54:31,P5L
671,C,409,125,534,2019-10-18,10:54:31,P6
672,C,4,2,6,2019-10-18,10:54:31,P6L
673,C,436,101,537,2015-10-23,13:21:14,P6M
674,C,598,136,734,2019-10-18,10:53:43,PL14
675,C,59,218,277,2019-10-18,10:54:02,PL15
676,C,162,113,275,2019-10-18,10:54:02,PL25
677,C,211,91,302,2019-10-18,10:53:42,PL29
678,C,147,57,204,2019-10-18,10:53:53,PL30
679,C,148,72,220,2019-10-18,10:53:45,PL31
680,C,142,59,201,2019-10-18,10:53:45,PL32
681,C,43,15,58,2019-10-18,10:53:43,PL33
682,C,256,167,423,2019-10-18,10:53:46,PL39
683,C,181,61,242,2019-10-18,10:53:46,PL40
684,C,279,169,448,2019-10-18,10:53:44,PL41
685,C,391,211,602,2019-10-18,10:53:43,PL42
686,C,31,8,39,2019-10-18,10:53:43,PL44
687,C,204,136,340,2019-10-18,10:54:02,PL45
688,C,254,172,426,2019-10-18,10:53:43,PL46
689,C,280,178,458,2019-10-18,10:53:50,PL48
690,C,108,67,175,2019-10-18,10:50:39,J10
691,C,96,33,129,2019-10-18,10:50:47,J11
692,C,678,1755,2433,2019-10-18,10:50:50,CK32
693,C,371,182,553,2019-10-18,10:50:51,BJ51
694,C,834,754,1588,2019-10-18,10:50:46,BJ52
695,C,347,60,407,2019-10-18,10:50:53,SK25
696,C,360,70,430,2019-10-18,10:50:45,SK26
697,C,882,192,1074,2019-10-18,10:51:53,SK32
698,C,882,192,1074,2019-10-18,10:51:53,SK33
699,C,778,48,826,2019-10-18,10:53:47,HG11
700,C,212,154,366,2019-10-18,10:53:47,PL68
701,C,375,324,699,2019-10-18,10:53:47,PL69
702,C,0,496,496,2019-10-18,10:54:01,MLM
703,C,1,31,32,2019-10-18,10:54:56,CR2
704,C,0,28,28,2019-10-18,10:54:11,CR3
705,C,430,53,483,2019-10-18,10:52:25,W57
706,C,0,48,48,2019-10-18,10:54:19,BE36
707,C,3,23,26,2019-10-18,10:54:20,BE37
708,C,391,16,407,2019-10-18,10:54:20,BE38
709,C,672,163,835,2019-10-18,10:54:20,BE42
710,C,89,33,122,2019-10-18,10:54:17,BE7
711,C,224,65,289,2019-10-18,10:54:15,SE13
712,C,479,194,673,2019-10-18,10:54:16,SE16
713,C,66,72,138,2019-10-18,10:54:40,SM1
714,C,114,24,138,2019-10-18,10:54:13,SM3
715,C,17,16,33,2019-10-18,10:54:06,JB3
716,C,108,39,147,2019-10-18,10:54:12,JB4
717,C,0,95,95,2019-10-18,10:54:15,K2
718,C,11,63,74,2019-10-18,10:54:14,K2T
719,C,73,56,129,2019-10-18,10:35:49,KM2
720,C,371,159,530,2019-10-18,10:54:15,KM3
721,C,196,73,269,2019-10-18,10:54:06,TRS
722,C,285,0,285,2019-10-18,10:54:14,ACM
723,C,602,174,776,2019-10-18,10:54:13,GE1A
724,C,32,18,50,2019-10-18,10:54:12,GE1F
725,C,0,48,48,2019-10-18,10:54:13,GE1G
726,C,134,59,193,2019-10-18,10:54:10,GE2
727,C,284,56,340,2019-10-18,10:54:07,GE3
728,C,255,0,255,2019-10-18,10:54:13,GE5
729,C,19,62,81,2019-10-18,10:54:12,JB1
730,C,5,38,43,2019-10-18,10:54:14,JB2
731,C,342,87,429,2019-10-18,10:54:08,K7
732,C,218,211,429,2019-10-18,10:54:09,KM4
733,C,183,73,256,2019-10-18,10:54:09,LT1
734,C,23,42,65,2019-10-18,10:54:09,LT2
735,C,197,70,267,2019-10-18,10:54:10,LT3
736,C,190,150,340,2019-10-18,10:54:07,M1
737,C,302,90,392,2019-10-18,10:54:08,M32
738,C,116,45,161,2019-10-18,10:54:12,MP1
739,C,13,72,85,2019-10-18,10:54:20,MP17
740,C,250,51,301,2019-10-18,10:54:13,MP2
741,C,126,39,165,2019-10-18,10:54:19,MP5
742,C,81,77,158,2019-10-18,10:54:10,MP5M
743,C,15,17,32,2019-10-18,10:54:10,MP5S
744,C,29,44,73,2019-10-18,10:54:19,MP6
745,C,102,100,202,2019-10-18,10:54:17,MP7
746,C,356,100,456,2019-10-18,10:52:43,SK9
747,C,370,74,444,2019-10-18,10:53:27,SK14
748,C,523,151,674,2019-10-18,10:54:25,BE10
749,C,334,69,403,2019-10-18,10:54:26,BE11
750,C,155,77,232,2019-10-18,10:54:26,BE13
751,C,333,4,337,2019-10-18,10:54:14,BE14
752,C,47,22,69,2019-10-18,10:54:30,BE26
753,C,361,1,362,2019-10-18,10:54:31,BE27
754,C,201,94,295,2019-10-18,10:54:31,BE28
755,C,29,13,42,2019-10-18,10:54:15,BE29
756,C,304,53,357,2019-10-18,10:54:16,BE30
757,C,86,22,108,2019-10-18,10:54:18,BE31
758,C,355,2,357,2019-10-18,10:54:18,BE32
759,C,570,202,772,2019-10-18,10:54:41,BE4
760,C,459,167,626,2019-10-18,10:54:19,BE5
761,C,55,125,180,2019-10-18,10:54:25,BE6
762,C,607,170,777,2019-10-18,10:54:13,BE9
763,C,242,5,247,2019-10-18,10:50:59,CLM
764,C,0,80,80,2019-10-18,10:51:04,BM14
765,C,16,20,36,2019-10-18,10:51:18,BM19
766,C,29,29,58,2019-10-18,10:51:18,BM20
767,C,119,31,150,2019-10-18,10:50:55,BM4
768,C,14,16,30,2019-10-18,10:51:05,BM6
769,C,398,3,401,2019-10-18,10:51:02,BVM2
770,C,69,897,966,2019-10-18,10:51:00,CM1
771,C,571,429,1000,2016-04-20,13:28:38,DUX
772,C,225,275,500,2019-10-18,10:51:00,H12
773,C,183,47,230,2019-10-18,10:51:04,H14
774,C,30,36,66,2019-10-18,10:50:58,H3
775,C,34,48,82,2019-10-18,10:54:05,H8
776,C,343,42,385,2019-10-18,10:51:00,HCM
777,C,11,7,18,2019-10-18,10:50:59,HE1
778,C,93,18,111,2019-10-18,10:50:58,HE19
779,C,11,26,37,2019-10-18,10:54:08,HE24
780,C,53,75,128,2019-10-18,10:51:01,HE4
781,C,492,0,492,2019-10-18,10:51:03,JMB1
782,C,16,395,411,2019-10-18,10:51:04,JRTM
783,C,420,3,423,2019-10-18,10:51:03,KTM
784,C,421,2,423,2019-10-18,10:51:02,KTM2
785,C,37,8,45,2019-10-18,10:51:19,KTM3
786,C,335,126,461,2019-10-18,10:51:09,KTM4
787,C,120,50,170,2019-10-18,10:51:00,LBM
788,C,100,0,100,2016-04-25,09:48:25,PGS
789,C,111,20,131,2019-10-18,10:54:05,PP9T
790,C,0,35,35,2016-02-16,11:37:54,RH3
791,C,173,52,225,2019-10-18,10:50:55,RHM2
792,C,101,299,400,2019-10-18,10:51:02,RHM3
793,C,21,261,282,2019-10-18,10:51:02,RHM4
794,C,0,35,35,2019-10-18,10:51:02,RHS
795,C,49,382,431,2019-10-18,10:54:06,HG30
796,C,21,62,83,2019-10-18,10:54:01,HG31
797,C,199,88,287,2019-10-18,10:54:07,HG32
798,C,101,85,186,2019-10-18,10:53:54,HG39
799,C,184,147,331,2019-10-18,10:53:57,HG47
800,C,669,164,833,2019-10-18,10:53:49,HG48
801,C,418,332,750,2019-10-18,10:53:53,HG49
802,C,240,175,415,2019-10-18,10:53:44,HG50
803,C,154,49,203,2019-10-18,10:54:09,HG51
804,C,156,33,189,2019-10-18,10:53:49,HG52
805,C,344,145,489,2019-10-18,10:53:58,HG54
806,C,17,72,89,2019-10-18,10:53:59,HG55
807,C,332,37,369,2019-10-18,10:53:47,HG60
808,C,254,58,312,2019-10-18,10:53:41,HG61
809,C,293,50,343,2019-10-18,10:53:50,HG62
810,C,219,474,693,2019-10-18,10:53:58,HG67
811,C,236,32,268,2019-10-18,10:54:04,HG68
812,C,109,94,203,2019-10-18,10:53:52,HG69
813,C,478,135,613,2019-10-18,10:54:06,HG7
814,C,226,466,692,2019-10-18,10:53:55,HG70
815,C,210,58,268,2019-10-18,10:53:42,HG76
816,C,275,148,423,2019-10-18,10:53:51,HG77
817,C,237,253,490,2019-10-18,10:53:49,HG78
818,C,215,186,401,2019-10-18,10:54:01,HG79
819,C,303,47,350,2019-10-18,10:54:09,HG89
820,C,842,54,896,2019-10-18,10:54:08,HG94
821,C,71,95,166,2019-10-18,10:53:56,HG95
822,C,28,11,39,2019-10-18,10:54:10,HG96
823,C,16,25,41,2019-10-18,10:54:04,HG97
824,C,97,57,154,2019-10-18,10:53:58,HG99
825,C,27,222,249,2019-10-18,10:50:45,J12
826,C,74,124,198,2019-10-18,10:50:48,J14
827,C,189,20,209,2019-10-18,10:50:41,J15
828,C,140,60,200,2019-10-18,10:50:31,J16
829,C,152,26,178,2019-10-18,10:50:26,J18
830,C,140,93,233,2019-10-18,10:50:49,J22
831,C,112,162,274,2019-10-18,10:50:47,J23
832,C,112,139,251,2019-10-18,10:50:51,J23M
833,C,285,96,381,2019-10-18,10:50:36,J8
834,C,83,107,190,2019-10-18,10:50:39,J9
835,C,445,40,485,2019-10-18,10:50:49,J90
836,C,482,113,595,2019-10-18,10:50:52,J91
837,C,412,50,462,2019-10-18,10:50:36,J92
838,C,441,50,491,2019-10-18,10:50:42,J93
839,C,396,48,444,2019-10-18,10:50:31,J94
840,C,433,34,467,2019-10-18,10:50:49,J95
841,C,425,20,445,2019-10-18,10:50:45,J96
842,C,327,84,411,2019-10-18,10:50:38,J97
843,C,233,48,281,2019-10-18,10:54:18,BBM2
844,C,631,142,773,2019-10-18,10:54:12,U12
845,C,3004,557,3561,2019-10-18,10:50:56,CK56
846,C,522,566,1088,2019-10-18,10:50:51,CK57
847,C,92,258,350,2019-10-18,10:53:50,U51
848,C,548,0,548,2016-02-10,20:02:17,ALL
849,C,244,142,386,2019-10-18,10:54:48,B59
850,C,158,114,272,2019-10-18,10:54:48,B60
851,C,444,109,553,2019-10-18,10:55:03,B97
852,C,98,33,131,2019-10-18,10:54:48,CC12
853,C,482,37,519,2019-10-18,10:53:55,SK39
854,C,82,118,200,2019-10-18,10:56:04,SK81
855,C,1,5,6,2019-10-18,10:54:14,P40L
856,C,227,127,354,2019-10-18,10:54:00,PM10
857,C,370,132,502,2019-10-18,10:54:16,PM25
858,C,18,190,208,2019-10-18,10:54:23,PR7
859,C,2,84,86,2019-10-18,10:55:19,MR5
860,C,1,85,86,2019-10-18,10:55:21,MR6
861,C,1,85,86,2019-10-18,10:55:21,MR7
862,C,208,81,289,2019-10-18,10:55:08,SG1
863,C,139,89,228,2019-10-18,10:55:08,SGLM
864,C,352,15,367,2019-10-18,10:52:11,W4M
865,C,425,9,434,2019-10-18,10:52:19,W59
866,C,351,25,376,2019-10-18,10:52:53,W554
867,C,382,47,429,2019-10-18,10:52:53,W549
868,C,331,19,350,2019-10-18,10:50:58,W81
869,C,374,86,460,2019-10-18,10:53:32,SK28
870,C,327,33,360,2019-10-18,10:51:35,W586
871,C,291,67,358,2019-10-18,10:51:35,W588
872,C,363,8,371,2016-02-05,14:34:00,BL19S
873,C,352,8,360,2015-08-19,12:21:16,J80MS
874,C,353,7,360,2015-08-19,12:37:42,J80S
875,C,0,10,10,2015-08-19,12:38:20,J84S
876,C,196,4,200,2015-08-19,12:33:46,J86S
877,C,789,178,967,2016-02-05,15:00:32,JM13S
878,C,455,71,526,2019-10-18,10:53:23,SK29
879,C,0,21,21,2019-10-18,10:53:25,W26
880,C,0,4,4,2019-10-18,10:53:46,W27
881,C,279,56,335,2019-10-18,10:53:29,PM8
882,C,102,52,154,2019-10-18,10:53:29,PR8
883,C,122,142,264,2019-10-18,10:56:06,SK69
884,C,144,122,266,2019-10-18,10:55:13,AH1
885,C,56,22,78,2019-10-18,10:55:03,BR14
886,C,74,90,164,2019-10-18,10:54:57,RC1
887,C,21,60,81,2019-10-18,10:54:46,TP12
888,C,4,61,65,2019-10-18,10:54:44,TP15
889,C,0,90,90,2019-10-18,10:55:07,TP20
890,C,130,53,183,2019-10-18,10:54:50,TP22
891,C,154,60,214,2019-10-18,10:54:48,TP3
892,C,29,3,32,2019-10-18,10:54:45,TP30
893,C,222,8,230,2019-10-18,10:54:48,TP34
894,C,230,66,296,2019-10-18,10:54:49,TP3A
895,C,358,2,360,2019-10-18,10:54:59,TP40
896,C,133,37,170,2019-10-18,10:55:01,TP41
897,C,0,115,115,2019-10-18,10:54:57,TP43
898,C,1,19,20,2019-10-18,10:54:47,TP48
899,C,249,219,468,2019-10-18,10:55:12,TP52
900,C,209,94,303,2019-10-18,10:54:50,TP53
901,C,276,50,326,2019-10-18,10:54:51,TP54
902,C,196,85,281,2019-10-18,10:54:44,TP60
903,C,114,35,149,2019-10-18,10:54:50,TP62
904,C,64,52,116,2019-10-18,10:54:51,TP63
905,C,192,6,198,2019-10-18,10:55:00,TP67
906,C,173,10,183,2019-10-18,10:54:46,TP7
907,C,137,43,180,2019-10-18,10:54:46,TP8
908,C,62,96,158,2019-10-18,10:54:58,TPB1
909,C,149,60,209,2019-10-18,10:54:47,TPM2
910,C,292,78,370,2019-10-18,10:55:08,TPM3
911,C,85,391,476,2019-10-18,10:54:45,TPM7
912,C,424,0,424,2019-10-18,10:54:47,TPM8
913,C,710,142,852,2019-10-18,10:54:46,TPM9
914,C,241,264,505,2019-10-18,10:54:47,TPMA
915,C,464,130,594,2019-10-18,10:54:50,TPMB
916,C,313,320,633,2019-10-18,10:54:48,TPMC
917,C,125,20,145,2019-10-18,10:54:59,TPMD
918,C,127,56,183,2019-10-18,10:54:47,TPME
919,C,386,74,460,2019-10-18,10:54:51,TPMF
920,C,246,0,246,2019-10-18,10:55:00,TPMH
921,C,594,62,656,2019-10-18,10:54:51,TPMJ
922,C,242,6,248,2019-10-18,10:55:01,TPMK
923,C,245,43,288,2019-10-18,10:54:48,TPML
924,C,245,84,329,2019-10-18,10:54:48,TPMM
925,C,667,110,777,2019-10-18,10:53:28,SK24
926,Y,200,-19,181,2016-02-19,11:19:28,SK24
927,H,200,-19,181,2016-02-19,11:19:29,SK24
928,C,182,64,246,2019-10-18,10:53:57,HG17
929,C,696,143,839,2019-10-18,10:54:07,HG75
930,C,335,69,404,2019-10-18,10:53:50,HG86
931,C,930,87,1017,2019-10-18,10:53:42,HG92
932,C,221,125,346,2019-10-18,10:55:01,Q86
933,C,9,9,18,2019-10-18,10:54:14,Q19
934,C,167,99,266,2019-10-18,10:54:01,MLM1
935,C,51,53,104,2019-10-18,10:53:30,STM1
936,C,170,50,220,2019-10-18,10:53:14,STM2
937,C,0,35,35,2019-10-18,10:53:16,STM3
938,C,196,25,221,2019-10-18,10:54:31,Q88
939,C,89,50,139,2019-10-18,10:54:50,Q8
940,C,189,86,275,2019-10-18,10:54:28,CDM
941,C,97,56,153,2019-10-18,10:53:54,PL16
942,C,244,47,291,2019-10-18,10:53:58,PL19
943,C,627,122,749,2019-10-18,10:53:55,PL24
944,C,245,154,399,2019-10-18,10:54:22,PL38
945,C,112,80,192,2019-10-18,10:53:43,PL50
946,C,204,117,321,2019-10-18,10:53:44,PL51
947,C,397,67,464,2019-10-18,10:50:56,CK2
948,C,47,37,84,2019-10-18,10:55:38,A28
949,C,251,59,310,2019-10-18,10:55:32,A31
950,C,19,138,157,2019-10-18,10:55:56,A44
951,C,201,50,251,2019-10-18,10:55:40,A27
952,C,167,186,353,2019-10-18,10:55:50,A75
953,C,393,369,762,2019-10-18,10:55:48,SE41
954,C,161,26,187,2019-10-18,10:55:48,A2
955,C,216,18,234,2019-10-18,10:55:41,A94
956,C,110,71,181,2019-10-18,10:54:00,HG1D
957,C,1117,737,1854,2019-10-18,10:51:00,CK54
958,C,82,38,120,2019-10-18,10:51:05,HE17
959,C,74,20,94,2019-10-18,10:50:56,SPS
960,C,88,115,203,2019-10-18,10:50:56,TB10
961,C,109,43,152,2019-10-18,10:50:58,TB11
962,C,1,17,18,2019-10-18,10:51:11,TB22
963,C,42,8,50,2019-10-18,10:54:09,TB23
964,C,10,8,18,2019-10-18,10:51:00,TB28
965,C,46,0,46,2019-10-18,10:51:02,TB4A
966,C,100,36,136,2019-10-18,10:50:37,TB6
967,C,144,42,186,2019-10-18,10:51:11,TB7
968,C,70,14,84,2019-10-18,10:50:59,TB8
969,C,544,0,544,2019-10-18,10:51:02,TBCM
970,C,63,32,95,2019-10-18,10:51:07,TE1
971,C,30,30,60,2019-10-18,10:51:00,YHS
972,C,272,432,704,2019-10-18,10:54:57,JM5
973,C,247,455,702,2019-10-18,10:54:58,JM6
974,C,681,10,691,2015-08-19,11:39:45,JM7M
975,C,474,4,478,2019-10-18,10:54:51,JM8
976,C,480,1,481,2015-08-19,11:39:45,JM8M
977,C,171,246,417,2019-10-18,10:54:46,JM9
978,C,1179,15,1194,2019-10-18,10:54:32,JSR1
979,C,147,78,225,2019-10-18,10:53:49,TJ27
980,C,485,70,555,2016-02-04,18:35:55,TJ28M
981,C,300,3,303,2019-10-18,10:53:49,TJ29
982,C,590,141,731,2019-10-18,10:54:57,TJ30
983,C,272,16,288,2016-02-05,15:39:25,TJ30S
984,C,544,0,544,2019-10-18,10:54:40,TJ32
985,C,438,3,441,2019-10-18,10:55:11,TJ33
986,C,439,1,440,2015-12-24,18:04:02,TJ33S
987,C,254,51,305,2019-10-18,10:55:11,TJ36
988,C,230,66,296,2019-10-18,10:54:50,TP4A
989,C,233,69,302,2019-10-18,10:53:30,CV1
990,C,42,37,79,2019-10-18,10:52:34,CV3
991,C,337,117,454,2019-10-18,10:53:30,PM32
992,C,336,116,452,2019-10-18,10:53:30,PM33
993,C,321,121,442,2019-10-18,10:53:30,PM34
994,C,697,462,1159,2019-10-18,10:54:44,Y19
995,C,192,59,251,2019-10-18,10:54:57,Y18
996,C,239,52,291,2019-10-18,10:54:24,Y26
997,C,7,1,8,2019-10-18,10:54:21,S28L
998,C,4,24,28,2019-10-18,10:54:00,CV2
999,C,0,21,21,2019-10-18,10:53:44,S30L
1000,C,296,129,425,2019-10-18,10:53:44,SK30
1001,C,519,99,618,2019-10-18,10:53:13,SK31
1002,C,512,142,654,2019-10-18,10:53:44,SK38
1003,C,0,18,18,2019-10-18,10:53:44,SK59
1004,C,457,33,490,2019-10-18,10:51:54,W79
1005,C,281,41,322,2019-10-18,10:51:54,W80
1006,C,383,18,401,2019-10-18,10:52:23,W87
1007,C,397,46,443,2019-10-18,10:52:24,W88
1008,C,351,38,389,2019-10-18,10:51:35,W92
1009,C,368,152,520,2019-10-18,10:52:51,SK94
1010,C,14,27,41,2019-10-18,10:54:20,SD4
1011,C,145,24,169,2019-10-18,10:53:42,PM12
1012,C,209,21,230,2019-10-18,10:54:04,MP3M
1013,C,301,1,302,2019-10-18,10:54:03,MP4M
1014,C,178,66,244,2019-10-18,10:52:46,PM38
1015,C,0,18,18,2019-10-18,10:54:38,EPL
1016,C,98,62,160,2019-10-18,10:54:36,B86
1017,C,408,168,576,2019-10-18,10:54:10,MP2M
1018,C,111,26,137,2018-04-01,00:04:09,W15
1019,C,275,0,275,2019-10-18,10:54:30,BE25
1020,C,184,85,269,2019-10-18,10:54:14,BE33
1021,C,137,41,178,2019-10-18,10:54:22,L1
1022,C,364,122,486,2019-10-18,10:54:34,SE15
1023,C,433,3,436,2019-10-18,10:54:36,SE17
1024,C,94,185,279,2019-10-18,10:54:42,SE18
1025,C,230,328,558,2019-10-18,10:54:14,SE19
1026,C,176,63,239,2019-10-18,10:54:22,SE25
1027,C,161,53,214,2019-10-18,10:54:22,SE26
1028,C,273,107,380,2019-10-18,10:54:33,SE27
1029,C,186,0,186,2019-10-18,10:54:22,SE28
1030,C,233,100,333,2019-10-18,10:54:23,SE29
1031,C,87,86,173,2019-10-18,10:54:20,SH2
1032,C,269,54,323,2019-10-18,10:52:44,W43
1033,C,111,36,147,2019-10-18,10:53:47,HG5
1034,C,335,72,407,2019-10-18,10:52:54,W46
1035,C,16,4,20,2019-10-18,10:55:02,TP68
1036,C,625,375,1000,2019-10-18,10:51:00,DUXM
1037,C,230,66,296,2019-10-18,10:54:50,TP49
1038,C,230,66,296,2019-10-18,10:54:51,TP50
1039,C,197,129,326,2019-10-18,10:53:59,SI1
1040,C,151,57,208,2019-10-18,10:54:11,SI11
1041,C,124,44,168,2019-10-18,10:54:11,SI12
1042,C,249,66,315,2019-10-18,10:53:59,SIM1
1043,C,260,46,306,2019-10-18,10:53:55,SIM2
1044,C,184,52,236,2019-10-18,10:54:11,SIM3
1045,C,186,98,284,2019-10-18,10:54:05,T34
1046,C,376,254,630,2019-10-18,10:54:05,T35
1047,C,193,97,290,2019-10-18,10:53:57,T4
1048,C,179,52,231,2019-10-18,10:54:13,T75
1049,C,243,105,348,2019-10-18,10:54:08,T80
1050,C,328,111,439,2019-10-18,10:53:55,TM11
1051,C,256,90,346,2019-10-18,10:54:01,TM12
1052,C,154,53,207,2019-10-18,10:53:49,TM13
1053,C,263,98,361,2019-10-18,10:54:14,TM14
1054,C,337,111,448,2019-10-18,10:54:11,TM17
1055,C,194,112,306,2019-10-18,10:54:07,TM18
1056,C,236,102,338,2019-10-18,10:54:00,TM21
1057,C,257,88,345,2019-10-18,10:54:01,TM22
1058,C,201,89,290,2019-10-18,10:53:57,TM28
1059,C,259,13,272,2019-10-18,10:53:57,TM29
1060,C,340,88,428,2019-10-18,10:54:15,TM3
1061,C,304,104,408,2019-10-18,10:54:03,TM30
1062,C,327,149,476,2019-10-18,10:53:56,TM31
1063,C,353,107,460,2019-10-18,10:53:56,TM32
1064,C,384,128,512,2019-10-18,10:54:11,TM4
1065,C,173,24,197,2019-10-18,10:54:11,TM49
1066,C,362,139,501,2019-10-18,10:54:11,TM5
1067,C,311,135,446,2019-10-18,10:53:50,PL23
1068,C,303,104,407,2019-10-18,10:53:50,PL27
1069,C,240,37,277,2019-10-18,10:54:21,PL34
1070,C,180,54,234,2019-10-18,10:54:22,PL35
1071,C,183,103,286,2019-10-18,10:54:22,PL37
1072,C,0,20,20,2019-10-18,10:54:21,P34L
1073,C,10,0,10,2019-10-18,10:54:22,P35L
1074,C,366,225,591,2019-10-18,10:53:59,SI2
1075,C,268,192,460,2019-10-18,10:53:55,SI4
1076,C,425,220,645,2019-10-18,10:53:40,T32
1077,C,244,98,342,2019-10-18,10:54:35,B28
1078,C,194,66,260,2019-10-18,10:54:13,SIM5
1079,C,10524,252,10776,2019-10-18,10:50:38,TWM1
1080,C,0,150,150,2019-10-18,10:55:27,A52
1081,C,583,287,870,2019-10-18,10:55:32,A53
1082,C,332,411,743,2019-10-18,10:55:56,A54
1083,C,296,41,337,2019-10-18,10:55:41,AM51
1084,C,183,51,234,2019-10-18,10:55:06,B47
1085,C,146,64,210,2019-10-18,10:55:06,B48
1086,C,389,303,692,2019-10-18,10:50:52,J21
1087,C,10,16,26,2019-10-18,10:53:23,SM9
1088,C,378,42,420,2018-08-13,06:36:53,Q82
1089,C,136,100,236,2019-10-18,10:53:41,HG2
1090,C,102,221,323,2019-10-18,10:54:09,HG2B
1091,C,329,51,380,2019-10-18,10:53:40,HG4
1092,C,0,200,200,2019-10-18,10:54:28,GSM
1093,C,453,61,514,2019-10-18,10:53:36,SK40
1094,C,319,73,392,2019-10-18,10:53:06,SK41
1095,C,330,88,418,2019-10-18,10:53:53,SK44
1096,C,375,96,471,2019-10-18,10:53:16,SK48
1097,C,423,60,483,2019-10-18,10:50:31,SK49
1098,C,384,87,471,2019-10-18,10:53:27,SK50
1099,C,469,72,541,2019-10-18,10:53:22,SK51
1100,C,138,89,227,2019-10-18,10:55:10,KEM1
1101,C,0,127,127,2019-10-18,10:54:56,BR8
1102,C,5,126,131,2019-10-18,10:55:02,BR6
1103,C,0,59,59,2019-10-18,10:55:03,BR10
1104,C,0,22,22,2019-10-18,10:54:29,GSML
1105,C,417,501,918,2019-10-18,10:50:33,CK53
1106,C,952,100,1052,2019-10-18,10:54:02,HG73
1107,C,675,34,709,2019-10-18,10:51:05,W106
1108,C,651,45,696,2019-10-18,10:53:24,W104
1109,C,104,22,126,2019-10-18,10:53:24,W105
1110,C,290,111,401,2019-10-18,10:50:32,CK10
1111,C,37,8,45,2019-10-18,10:50:38,CK9
1112,C,596,213,809,2019-10-18,10:54:13,EC2
1113,C,0,46,46,2019-10-18,10:54:21,EC3
1114,C,19,95,114,2019-10-18,10:54:21,EC4
1115,C,275,132,407,2019-10-18,10:54:03,ECM
1116,C,108,17,125,2019-10-18,10:54:09,M33
1117,C,338,211,549,2019-10-18,10:50:41,CK59
1118,C,188,85,273,2019-10-18,10:50:38,CKM9
1119,C,296,87,383,2019-10-18,10:52:59,W782
1120,C,552,116,668,2019-10-18,10:53:27,SK5
1121,C,237,378,615,2019-10-18,10:54:04,PL18
1122,C,532,83,615,2019-10-18,10:54:05,PL21
1123,C,261,156,417,2019-10-18,10:53:43,PL43
1124,C,460,209,669,2019-10-18,10:54:01,PL59
1125,C,445,142,587,2019-10-18,10:53:55,PL52
1126,C,347,119,466,2019-10-18,10:53:57,PL65
1127,C,425,34,459,2019-10-18,10:53:55,W12M
1128,C,10,0,10,2016-06-03,13:30:14,W12L
1129,C,415,32,447,2019-10-18,10:52:05,W93
1130,C,311,133,444,2019-10-18,10:55:02,PM26
1131,C,7,56,63,2019-10-18,10:50:46,BJ14
1132,C,3,35,38,2019-10-18,10:50:52,BJ15
1133,C,200,111,311,2019-10-18,10:50:49,BJ16
1134,C,0,16,16,2019-10-18,10:50:50,BJ23
1135,C,504,498,1002,2019-10-18,10:50:40,BJ44
1136,C,42,18,60,2019-10-18,10:50:47,BJMP
1137,C,99,44,143,2019-10-18,10:55:37,SG4
1138,C,443,160,603,2019-10-18,10:54:04,Y12
1139,C,63,64,127,2019-10-18,10:54:07,EC7
1140,C,181,53,234,2019-10-18,10:53:11,Y62M
1141,C,19,34,53,2019-10-18,10:54:18,Q68
1142,C,12,83,95,2019-10-18,10:54:04,Q65
1143,C,387,99,486,2019-10-18,10:52:39,SK89
1144,C,142,54,196,2019-10-18,10:54:05,AR1M
1145,C,237,318,555,2019-10-18,10:55:37,A35
1146,C,148,249,397,2019-10-18,10:55:38,A45
1147,C,34,28,62,2019-10-18,10:55:31,A48
1148,C,83,49,132,2019-10-18,10:55:32,A64
1149,C,72,28,100,2019-10-18,10:51:07,TB19
1150,C,142,64,206,2019-10-18,10:54:53,Y5
1151,C,509,98,607,2019-10-18,10:53:59,Q77M
1152,C,0,31,31,2019-10-18,10:53:58,Q80
1153,C,67,81,148,2019-10-18,10:53:58,Q85
1154,C,299,42,341,2019-10-18,10:52:02,W570
1155,C,161,205,366,2019-10-18,10:51:15,TB17
1156,C,421,2,423,2019-10-18,10:51:15,TBM5
1157,C,392,8,400,2019-10-18,10:51:15,TBM6
1158,C,520,9,529,2019-10-18,10:51:16,TBM7
1159,C,328,51,379,2019-10-18,10:53:05,PM23
1160,C,232,124,356,2019-10-18,10:53:07,PR13
1161,C,425,148,573,2019-10-18,10:52:58,SK95
1162,C,375,133,508,2019-10-18,10:52:05,SK90
1163,C,37,128,165,2019-10-18,10:54:04,EC8
1164,C,218,139,357,2019-10-18,10:54:09,Y6
1165,C,24,16,40,2019-10-18,10:53:49,Y58
1166,C,51,73,124,2019-10-18,10:55:53,A87
1167,C,85,223,308,2019-10-18,10:55:46,A41
1168,C,33,133,166,2019-10-18,10:55:29,A42
1169,C,283,285,568,2019-10-18,10:53:50,HG19
1170,C,335,310,645,2019-10-18,10:53:46,HG20
1171,C,212,288,500,2019-10-18,10:54:02,HG23
1172,C,393,57,450,2019-10-18,10:52:55,W82
1173,C,456,8,464,2019-10-18,10:52:55,W95
1174,C,334,46,380,2019-10-18,10:55:17,SB33
1175,C,333,139,472,2019-10-18,10:54:30,Y41
1176,C,334,17,351,2019-10-18,10:54:30,Y41M
1177,C,163,159,322,2019-10-18,10:50:50,J6
1178,C,686,264,950,2019-10-18,10:50:50,J7
1179,C,463,52,515,2019-10-18,10:52:31,W85
1180,C,284,67,351,2019-10-18,10:50:38,SK85
1181,C,199,95,294,2019-10-18,10:54:00,SI10
1182,C,35,19,54,2019-10-18,10:53:42,SI6
1183,C,307,57,364,2019-10-18,10:53:43,SI7
1184,C,102,16,118,2019-10-18,10:53:43,SI8
1185,C,122,68,190,2019-10-18,10:54:12,SI9
1186,C,283,110,393,2019-10-18,10:54:13,T20
1187,C,196,30,226,2019-10-18,10:54:09,T30
1188,C,123,70,193,2019-10-18,10:54:09,T31
1189,C,310,152,462,2019-10-18,10:54:17,T79
1190,C,450,235,685,2019-10-18,10:54:15,T81
1191,C,250,49,299,2019-10-18,10:54:14,TM15
1192,C,213,71,284,2019-10-18,10:54:13,TM16
1193,C,186,30,216,2019-10-18,10:54:15,TM44
1194,C,14,26,40,2019-10-18,10:54:35,Q17
1195,C,11,29,40,2016-10-19,03:42:55,Q16A
1196,C,106,124,230,2019-10-18,10:54:16,Q96
1197,C,168,150,318,2019-10-18,10:53:54,HG74
1198,C,10,16,26,2019-10-18,10:54:47,B41
1199,C,174,43,217,2019-10-18,10:54:39,B43
1200,C,62,4,66,2019-10-18,10:54:31,B46
1201,C,126,57,183,2019-10-18,10:54:39,B49
1202,C,237,175,412,2019-10-18,10:54:32,B72
1203,C,0,50,50,2019-10-18,10:54:22,B73
1204,C,333,32,365,2019-10-18,10:54:22,B74
1205,C,10,11,21,2019-10-18,10:55:00,B7B
1206,C,152,60,212,2019-10-18,10:54:54,B83
1207,C,456,103,559,2019-10-18,10:54:12,B85
1208,C,334,104,438,2019-10-18,10:54:39,B94
1209,C,130,56,186,2019-10-18,10:54:39,B94A
1210,C,296,212,508,2019-10-18,10:54:54,B99M
1211,C,18,3,21,2016-05-13,18:05:48,BB
1212,C,87,0,87,2017-06-01,14:27:28,CC1
1213,C,99,134,233,2019-10-18,10:54:36,CC10
1214,C,319,98,417,2019-10-18,10:54:29,CC11
1215,C,296,91,387,2019-10-18,10:54:54,CC4
1216,C,78,69,147,2019-10-18,10:54:39,CC8
1217,C,105,18,123,2019-10-18,10:54:36,CC9
1218,C,406,154,560,2019-10-18,10:53:37,PL10
1219,C,448,100,548,2019-10-18,10:53:37,PL11
1220,C,255,108,363,2019-10-18,10:54:01,PL28
1221,C,115,206,321,2019-10-18,10:55:02,BR4
1222,C,275,234,509,2019-10-18,10:54:09,Q75M
1223,C,5,18,23,2019-10-18,10:54:03,C18A
1224,C,158,122,280,2019-10-18,10:54:01,C16
1225,C,93,31,124,2019-10-18,10:54:02,C18
1226,C,550,146,696,2019-10-18,10:54:02,AR2M
1227,C,240,55,295,2019-10-18,10:54:08,AR7M
1228,C,259,43,302,2019-10-18,10:52:56,W68
1229,C,426,17,443,2019-10-18,10:54:56,BL15
1230,C,5,14,19,2019-10-18,10:54:01,Q16
1231,C,224,69,293,2019-10-18,10:54:10,T26
1232,C,92,44,136,2019-10-18,10:54:10,T27
1233,C,165,63,228,2019-10-18,10:54:11,T28
1234,C,196,60,256,2019-10-18,10:54:10,T29
1235,C,176,234,410,2019-10-18,10:53:59,TM8
1236,C,219,95,314,2019-10-18,10:53:43,PL47
1237,C,143,113,256,2019-10-18,10:53:44,PL49
1238,C,77,54,131,2019-10-18,10:50:29,J19
1239,C,0,34,34,2019-10-18,10:50:46,J24
1240,C,5,25,30,2019-10-18,10:50:54,J25
1241,C,0,31,31,2019-10-18,10:50:55,J26
1242,C,256,74,330,2019-10-18,10:50:29,J64
1243,C,597,263,860,2019-10-18,10:54:39,B19
1244,C,796,284,1080,2019-10-18,10:54:32,B44
1245,C,397,90,487,2019-10-18,10:51:44,SK27
1246,C,56,87,143,2019-10-18,10:51:20,TE13
1247,C,329,56,385,2019-10-18,10:52:56,SK96
1248,C,1,3,4,2019-10-18,10:54:03,AR2L
1249,C,48,14,62,2019-10-18,10:55:53,A10
1250,C,38,13,51,2019-10-18,10:55:39,A8
1251,C,317,42,359,2019-10-18,10:54:00,B95
1252,C,198,44,242,2019-10-18,10:54:00,B96
1253,C,12,265,277,2019-10-18,10:54:03,AV1
1254,C,43,59,102,2019-10-18,10:54:02,H4
1255,C,33,196,229,2019-10-18,10:54:03,H17
1256,C,0,336,336,2019-10-18,10:54:04,H18
1257,C,161,37,198,2019-10-18,10:54:05,Y16
1258,C,580,100,680,2019-10-18,10:53:43,S102
1259,C,1,21,22,2019-10-18,10:54:55,BKE1
1260,C,0,38,38,2019-10-18,10:54:56,BKE9
1261,C,244,184,428,2019-10-18,10:54:55,Y17
1262,C,381,153,534,2019-10-18,10:54:31,JM16
1263,C,945,9,954,2019-10-18,10:54:31,JM17
1264,C,464,100,564,2019-10-18,10:51:55,SK67
1265,C,251,131,382,2019-10-18,10:53:53,PL36
1266,C,508,57,565,2019-10-18,10:53:33,SK65
1267,C,342,49,391,2019-10-18,10:53:26,SK64
1268,C,0,122,122,2019-10-18,10:55:02,CR1
1269,C,72,119,191,2019-10-18,10:54:29,BBB
1270,C,303,319,622,2019-10-18,10:54:47,BM31
1271,C,88,172,260,2019-10-18,10:54:34,CSM
1272,C,100,164,264,2019-10-18,10:54:45,FRM
1273,C,0,64,64,2019-10-18,10:54:09,GE1B
1274,C,0,100,100,2019-10-18,10:54:23,GE1C
1275,C,160,71,231,2019-10-18,10:54:22,GEM
1276,C,10,114,124,2019-10-18,10:51:04,HG15
1277,C,29,42,71,2019-10-18,10:50:51,HG16
1278,C,185,234,419,2019-10-18,10:51:07,HG25
1279,C,127,122,249,2019-10-18,10:50:47,HG37
1280,C,705,574,1279,2019-10-18,10:50:55,HG38
1281,C,186,249,435,2019-10-18,10:50:53,HG45
1282,C,115,137,252,2019-10-18,10:51:08,HG46
1283,C,549,150,699,2019-10-18,10:50:56,HG88
1284,C,84,162,246,2019-10-18,10:50:47,HG9
1285,C,50,95,145,2019-10-18,10:50:41,HG9T
1286,C,236,136,372,2019-10-18,10:54:30,JCM
1287,C,0,2,2,2019-10-18,10:54:00,JCML
1288,C,39,57,96,2019-10-18,10:54:16,K10
1289,C,112,218,330,2019-10-18,10:22:46,KAM
1290,C,2,4,6,2019-10-18,10:22:47,KAML
1291,C,20,0,20,2018-01-25,05:07:01,KAMS
1292,C,354,70,424,2019-10-18,10:54:09,KM1
1293,C,0,3,3,2017-04-01,09:28:33,LUB
1294,C,15,45,60,2019-10-18,10:54:29,MP14
1295,C,0,23,23,2019-10-18,10:54:29,MP15
1296,C,0,22,22,2019-10-18,10:54:30,MP16
1297,C,344,167,511,2019-10-18,10:54:01,MP19
1298,C,163,204,367,2019-10-18,10:50:46,PR3
1299,C,163,173,336,2019-10-18,10:51:07,PR6
1300,C,254,244,498,2019-10-18,10:54:33,PRM
1301,C,478,111,589,2019-10-18,10:51:08,SIM4
1302,C,3,5,8,2019-10-18,10:50:58,T55
1303,C,258,160,418,2019-10-18,10:50:50,TAM1
1304,C,596,262,858,2019-10-18,10:53:46,KE1
1305,C,144,115,259,2019-10-18,10:54:23,EI3
1306,C,52,26,78,2019-10-18,10:54:29,HR1
1307,C,138,49,187,2019-10-18,10:54:00,HR2
1308,C,117,110,227,2019-10-18,10:54:01,HR3
1309,C,8,95,103,2019-10-18,10:54:01,HR4
1310,C,57,34,91,2019-10-18,10:54:26,HR5
1311,C,0,150,150,2019-10-18,10:53:56,B24
1312,C,46,92,138,2019-10-18,10:53:36,B25
1313,C,280,90,370,2019-10-18,10:54:08,B69
1314,C,0,24,24,2019-10-18,10:54:14,T77
1315,C,375,158,533,2019-10-18,10:54:14,TAM2
1316,C,188,76,264,2019-10-18,10:50:57,BJ25
1317,C,198,66,264,2019-10-18,10:50:45,BJ26
1318,C,39,29,68,2019-10-18,10:50:50,BJ62
1319,C,10486,188,10674,2019-10-18,10:50:36,TWM2
1320,C,551,729,1280,2019-10-18,10:53:54,HG87
1321,C,371,413,784,2019-10-18,10:53:53,HG90
1322,C,352,435,787,2019-10-18,10:53:41,HG91
1323,C,4,80,84,2019-10-18,10:54:55,SD11
1324,C,353,114,467,2019-10-18,10:53:43,BRM
1325,C,4,0,4,2018-12-26,13:34:57,B23T
1326,C,343,16,359,2019-10-18,10:52:57,W94
1327,C,458,1,459,2019-10-18,10:54:50,JM21
1328,C,786,0,786,2019-10-18,10:54:50,JM24
1329,C,146,78,224,2019-10-18,10:54:09,T43
1330,C,103,126,229,2019-10-18,10:54:09,T44
1331,C,235,104,339,2019-10-18,10:54:09,T45
1332,C,43,254,297,2019-10-18,10:54:10,T46
1333,C,90,10,100,2019-10-18,10:54:17,TM19
1334,C,165,69,234,2019-10-18,10:54:18,TM20
1335,C,23,27,50,2019-10-18,10:55:13,BR9
1336,C,1,24,25,2019-10-18,10:49:20,Q73
1337,C,5,20,25,2019-10-18,10:49:06,Q70
1338,C,9,69,78,2019-10-18,10:49:24,Q67
1339,C,41,36,77,2019-10-18,10:54:59,J66
1340,C,70,86,156,2019-10-18,10:54:59,J67
1341,C,213,63,276,2019-10-18,10:54:59,J68M
1342,C,8,103,111,2019-10-18,10:55:08,PP6
1343,C,170,81,251,2019-10-18,10:54:06,SIM6
1344,C,98,69,167,2019-10-18,10:54:44,KJ1
1345,C,70,30,100,2019-10-18,10:54:55,KJ2
1346,C,133,92,225,2019-10-18,10:50:46,B26
1347,C,130,130,260,2019-10-18,10:50:50,B27
1348,C,1347,183,1530,2018-06-08,15:03:35,GMLM
1349,C,0,65,65,2019-10-18,10:54:54,GM2
1350,C,0,56,56,2019-10-18,10:54:54,GM3
1351,C,0,118,118,2019-10-18,10:54:55,GM5
1352,C,113,33,146,2019-10-18,10:54:55,GM2A
1353,C,123,109,232,2019-10-18,10:54:56,GM6B
1354,C,368,99,467,2019-10-18,10:54:04,KJM2
1355,C,475,112,587,2019-10-18,10:54:53,HVM
1356,C,239,162,401,2019-10-18,10:50:44,T1
1357,C,150,113,263,2019-10-18,10:50:55,T3
1358,C,54,52,106,2019-10-18,10:51:07,T7
1359,C,48,163,211,2019-10-18,10:51:09,T8
1360,C,151,183,334,2019-10-18,10:54:35,KJ3
1361,C,243,22,265,2019-10-18,10:53:52,KJM1
1362,C,81,99,180,2019-10-18,10:54:02,KJ4
1363,C,301,143,444,2019-10-18,10:54:02,CVBK
1364,C,190,88,278,2019-10-18,10:54:14,BKRM
1365,C,884,68,952,2019-10-18,10:53:34,U52
1366,C,0,1200,1200,2019-10-18,10:51:00,CK62
1367,C,563,303,866,2019-10-18,10:50:47,CK63
1368,C,1069,215,1284,2019-10-18,10:50:40,CK64
1369,C,341,38,379,2019-10-18,10:53:51,P8
1370,C,290,92,382,2019-10-18,10:53:52,P9
1371,C,103,321,424,2019-10-18,10:53:51,PL53
1372,C,147,42,189,2019-10-18,10:54:49,RC2
1373,C,191,76,267,2019-10-18,10:54:58,RC3
1374,C,452,66,518,2019-10-18,10:53:50,SK66
1375,C,257,78,335,2019-10-18,10:54:51,BRM1
1376,C,199,85,284,2019-10-18,10:54:57,Y36
1377,C,246,152,398,2019-10-18,10:50:51,CK11
1378,C,302,43,345,2019-10-18,10:50:47,CK35
1379,C,60,36,96,2019-10-18,10:54:26,K19
1380,C,559,100,659,2019-10-18,10:53:28,SK18
1381,C,107,55,162,2019-10-18,10:50:38,J17
1382,C,251,114,365,2019-10-18,10:50:28,J20
1383,C,24,65,89,2019-10-18,10:51:04,HE9
1384,C,792,131,923,2019-10-18,10:54:34,JM20
1385,C,245,50,295,2019-10-18,10:53:40,PM24
1386,C,58,24,82,2019-10-18,10:53:40,PR14
1387,C,309,67,376,2019-10-18,10:54:55,BRM5
1388,C,380,87,467,2019-10-18,10:55:03,BRM6
1389,C,115,97,212,2019-10-18,10:51:14,H6
1390,C,706,190,896,2019-10-18,10:53:44,P7
1391,C,2208,429,2637,2019-10-18,10:50:33,CK58
1392,C,199,104,303,2019-10-18,10:53:55,W11
1393,C,220,90,310,2019-10-18,10:53:55,W11M
1394,C,260,102,362,2019-10-18,10:53:45,BJ13
1395,C,189,170,359,2019-10-18,10:54:51,C11
1396,C,65,124,189,2019-10-18,10:54:29,C29
1397,C,163,48,211,2019-10-18,10:54:50,C30
1398,C,105,40,145,2019-10-18,10:54:51,C31
1399,C,598,207,805,2019-10-18,10:54:50,C33
1400,C,85,62,147,2019-10-18,10:54:34,C34
1401,C,446,201,647,2019-10-18,10:54:39,C35
1402,C,45,41,86,2019-10-18,10:54:51,C36
1403,C,104,319,423,2019-10-18,10:54:51,C37
1404,C,146,119,265,2019-10-18,10:54:39,C38
1405,C,213,88,301,2019-10-18,10:54:01,CKM2
1406,C,190,76,266,2019-10-18,10:54:45,CTM1
1407,C,489,177,666,2019-10-18,10:54:31,JMB2
1408,C,433,144,577,2019-10-18,10:54:48,JMB3
1409,C,0,30,30,2019-10-18,10:53:35,U11
1410,C,204,87,291,2019-10-18,10:53:47,U7
1411,C,84,37,121,2019-10-18,10:52:51,U8
1412,C,105,95,200,2019-10-18,10:55:43,A49
1413,C,394,240,634,2019-10-18,10:55:41,A76
1414,C,33,4,37,2019-10-18,10:53:59,U50
1415,C,14,8,22,2019-10-18,10:53:59,T57
1416,C,166,100,266,2019-10-18,10:54:04,T78
1417,C,271,75,346,2019-10-18,10:53:46,PM43
1418,C,288,60,348,2019-10-18,10:53:46,PM44
1419,C,152,157,309,2019-10-18,10:54:06,T73
1420,C,24,19,43,2019-10-18,10:54:48,BKE4
1421,C,455,37,492,2019-10-18,10:51:59,W69
1422,C,588,159,747,2019-10-18,10:53:53,PL12
1423,C,372,3,375,2016-12-25,12:34:06,PL13
1424,C,574,72,646,2019-10-18,10:50:44,SK46
1425,C,578,65,643,2019-10-18,10:52:07,SK47
1426,C,38,25,63,2019-10-18,10:53:48,JSA1
1427,C,427,236,663,2019-10-18,10:54:06,TJ39
1428,C,779,30,809,2019-10-18,10:53:53,TM6
1429,C,245,0,245,2019-10-18,10:53:54,TM7
1430,C,0,4,4,2019-10-18,10:54:09,AR7L
1431,C,835,659,1494,2019-10-18,10:50:48,CK75
1432,C,390,365,755,2019-10-18,10:50:48,CK76
1433,C,261,37,298,2019-10-18,10:51:41,W70
1434,C,344,37,381,2019-10-18,10:51:41,W74
1435,C,32,31,63,2019-10-18,10:44:39,CK65
1436,C,367,67,434,2019-10-18,10:53:47,SB1
1437,C,454,62,516,2019-10-18,10:53:14,SB6
1438,C,0,1000,1000,2018-10-12,16:48:40,WD1B
1439,C,720,280,1000,2019-03-02,03:59:46,BB8M
1440,C,218,782,1000,2018-11-02,03:59:39,JB42
1441,C,213,94,307,2019-10-18,10:51:00,TBM
1442,C,576,46,622,2019-10-18,10:54:27,B81
1443,C,539,218,757,2019-10-18,10:54:27,B92
1444,C,844,294,1138,2019-10-18,10:54:08,Y34
1445,C,188,47,235,2019-10-18,10:54:08,Y34A
1446,C,209,125,334,2019-10-18,10:54:39,B67
1447,C,148,84,232,2019-10-18,10:54:07,T74
1448,C,182,109,291,2019-10-18,10:54:00,TM10
1449,C,15,5,20,2019-10-18,10:54:00,TM9
1450,C,521,201,722,2019-10-18,10:54:16,SE12
1451,C,810,1142,1952,2019-10-18,10:50:32,CK70
1452,C,203,168,371,2019-10-18,10:50:33,CK71
1453,C,209,589,798,2019-10-18,10:50:48,CK77
1454,C,398,98,496,2019-10-18,10:53:50,SK34
1455,C,899,142,1041,2019-10-18,10:53:50,SK35
1456,C,370,185,555,2019-10-18,10:54:53,B21
1457,C,1121,37,1158,2019-10-18,10:52:46,W517
1458,C,227,151,378,2019-10-18,10:54:05,TM33
1459,C,246,217,463,2019-10-18,10:54:05,TM34
1460,C,134,153,287,2019-10-18,10:54:36,B89
1461,C,1,18,19,2019-10-18,10:54:17,Q94
1462,C,717,64,781,2019-10-18,10:53:35,W20
1463,C,551,194,745,2019-10-18,10:54:17,Y40
1464,C,36,31,67,2019-10-18,10:55:38,A100
1465,C,177,237,414,2019-10-18,10:55:55,A73
1466,C,114,76,190,2019-10-18,10:55:49,A74
1467,C,52,50,102,2019-10-18,10:54:17,Q66
1468,C,499,1,500,2017-02-06,10:23:27,BE232
1469,C,499,1,500,2017-02-06,10:23:27,BE241
1470,C,509,116,625,2019-10-18,10:54:10,TM35
1471,C,86,272,358,2019-10-18,10:54:03,BL22
1472,C,44,366,410,2019-10-18,10:53:58,JM32
1473,C,488,121,609,2019-10-18,10:54:03,PL17
1474,C,475,142,617,2019-10-18,10:54:03,PL20
1475,C,337,42,379,2019-10-18,10:54:04,PL22
1476,C,316,59,375,2019-10-18,10:54:04,PL26
1477,C,162,394,556,2019-10-18,10:54:02,BLM
1478,C,334,351,685,2019-10-18,10:54:02,HG71
1479,C,193,49,242,2019-10-18,10:54:05,TM23
1480,C,254,90,344,2019-10-18,10:54:05,TM24
1481,C,25,51,76,2019-10-18,10:53:46,W108
1482,C,0,300,300,2019-10-18,10:54:10,JM2
1483,C,540,7,547,2019-10-18,10:54:11,JM3
1484,C,427,8,435,2019-10-18,10:54:11,JM4
1485,C,563,10,573,2019-10-18,10:54:12,JM11
1486,C,555,16,571,2019-10-18,10:54:12,JM26
1487,C,530,7,537,2019-10-18,10:54:13,JM27
1488,C,568,25,593,2019-10-18,10:54:13,JSR2
1489,C,795,119,914,2019-10-18,10:52:49,SK55
1490,C,901,30,931,2019-10-18,10:54:00,UBM1
1491,C,20,15,35,2019-10-18,10:53:32,KB18
1492,C,202,21,223,2019-10-18,10:53:32,KB20
1493,C,410,26,436,2019-10-18,10:52:55,W578
1494,C,351,48,399,2019-10-18,10:52:55,W579
1495,C,467,100,567,2019-10-18,10:54:15,Y45M
1496,C,456,330,786,2019-10-18,10:53:58,HG42
1497,C,174,35,209,2019-10-18,10:54:40,KE2
1498,C,123,10,133,2019-10-18,10:54:41,KE4
1499,C,1251,518,1769,2019-10-18,10:50:58,BJ29
1500,C,358,282,640,2019-10-18,10:54:09,T72
1501,C,186,205,391,2019-10-18,10:55:55,A4
1502,C,77,153,230,2019-10-18,10:55:33,A24
1503,C,1,2,3,2019-10-18,10:54:22,GEML
1504,C,566,17,583,2019-10-18,10:51:37,W509
1505,C,538,36,574,2019-10-18,10:51:37,W516
1506,C,557,102,659,2019-10-18,10:53:57,HG1B
1507,C,153,105,258,2019-10-18,10:50:36,BJ24
1508,C,143,162,305,2019-10-18,10:50:47,BJ27
1509,C,504,507,1011,2019-10-18,10:54:35,B11
1510,C,443,22,465,2019-10-18,10:52:53,W86
1511,C,470,54,524,2019-10-18,10:52:53,W89
1512,C,10761,107,10868,2019-10-18,10:50:35,BJ66
1513,C,10736,264,11000,2019-10-18,10:50:42,BJ67
1514,C,51,20,71,2019-10-18,10:51:07,TB18
1515,C,186,38,224,2019-10-18,10:54:13,TM48
1516,C,0,4,4,2019-10-18,10:54:06,AR1L
1517,C,302,368,670,2019-10-18,10:53:53,PL56
1518,C,347,211,558,2019-10-18,10:53:46,PL60
1519,C,300,281,581,2019-10-18,10:54:29,B50
1520,C,319,58,377,2019-10-18,10:52:07,W71
1521,C,540,398,938,2019-10-18,10:53:49,PL61
1522,C,365,63,428,2019-10-18,10:53:50,PM21
1523,C,448,48,496,2019-10-18,10:53:15,Y43
1524,C,49,96,145,2019-10-18,10:54:28,B54
1525,C,8,43,51,2019-10-18,10:54:28,B91
1526,C,212,214,426,2019-10-18,10:54:25,B57
1527,C,272,93,365,2019-10-18,10:54:34,TJ35
1528,C,208,85,293,2019-10-18,10:54:34,TJ38
1529,C,571,126,697,2019-10-18,10:54:56,BL17
1530,C,117,33,150,2019-10-18,10:54:10,P13
1531,C,292,242,534,2019-10-18,10:53:48,PL66
1532,C,155,163,318,2019-10-18,10:53:54,HG12
1533,C,46,53,99,2019-10-18,10:54:01,HG13
1534,C,287,217,504,2019-10-18,10:53:42,HG14
1535,C,23,967,990,2019-10-18,10:54:14,DWSV
1536,C,381,267,648,2019-10-18,10:54:07,T48
1537,C,139,138,277,2019-10-18,10:54:07,TM45
1538,C,242,298,540,2019-10-18,10:54:25,B40
1539,C,317,17,334,2019-10-18,10:52:57,W527
1540,C,262,64,326,2019-10-18,10:52:57,W536
1541,C,215,133,348,2019-10-18,10:54:04,T76
1542,C,502,516,1018,2019-10-18,10:54:41,KE3
1543,C,134,96,230,2019-10-18,10:54:00,W676
1544,C,458,333,791,2019-10-18,10:52:38,PR2
1545,C,188,420,608,2019-10-18,10:53:59,Y25
1546,C,44,70,114,2019-10-18,10:54:00,Y25M
1547,C,267,210,477,2019-10-18,10:53:58,HG34
1548,C,633,1086,1719,2019-10-18,10:54:33,B79
1549,C,188,227,415,2019-10-18,10:54:01,HG35
1550,C,46,39,85,2019-10-18,10:55:43,SE37
1551,C,148,204,352,2019-10-18,10:55:34,SE42
1552,C,19,13,32,2019-10-18,10:55:35,SE43
1553,C,446,51,497,2019-10-18,10:53:39,PL54
1554,C,297,67,364,2019-10-18,10:53:40,PL55
1555,C,254,46,300,2019-10-18,10:53:40,PL62
1556,C,357,120,477,2019-10-18,10:54:04,KU2
1557,C,245,100,345,2019-10-18,10:54:28,KU3
1558,C,255,219,474,2019-10-18,10:54:27,KU4
1559,C,340,246,586,2019-10-18,10:54:01,KU1
1560,C,0,101,101,2019-10-18,10:54:02,KU9
1561,C,197,71,268,2019-10-18,10:54:51,BR11
1562,C,46,11,57,2019-10-18,10:54:52,BR12
1563,C,205,152,357,2019-10-18,10:53:48,HG24
1564,C,130,119,249,2019-10-18,10:54:04,HG29
1565,C,0,85,85,2019-10-18,10:54:47,CR6
1566,C,420,141,561,2019-10-18,10:54:15,SB17
1567,C,276,83,359,2019-10-18,10:54:13,SB20
1568,C,420,104,524,2019-10-18,10:54:14,SB25
1569,C,130,13,143,2019-10-18,10:54:14,SB32
1570,C,97,158,255,2019-10-18,10:54:41,KE3M
1571,C,541,90,631,2019-10-18,10:54:13,BL23
1572,C,194,90,284,2019-10-18,10:54:04,TM50
1573,C,273,248,521,2019-10-18,10:53:48,PL57
1574,C,258,308,566,2019-10-18,10:53:48,PL58
1575,C,42,67,109,2019-10-18,10:54:58,SD1
1576,C,438,271,709,2019-10-18,10:53:55,PR10
1577,C,586,211,797,2019-10-18,10:52:46,PM20
1578,C,103,47,150,2019-10-18,10:54:09,P16
1579,C,125,125,250,2019-10-18,10:54:06,T12
1580,C,263,129,392,2019-10-18,10:54:06,T13
1581,C,190,285,475,2019-10-18,10:54:15,CAM
1582,C,448,52,500,2019-10-18,10:50:43,CKM7
1583,C,2350,650,3000,2019-10-18,10:50:43,CKM8
1584,C,437,175,612,2019-10-18,10:53:41,HG1C
1585,C,517,20,537,2019-10-18,10:52:59,W56
1586,C,533,34,567,2019-10-18,10:52:59,W889
1587,C,1,9,10,2019-10-18,10:52:59,W56L
1588,C,270,16,286,2019-10-18,10:52:02,W887
1589,C,370,85,455,2019-10-18,10:54:21,MNM
1590,C,88,82,170,2019-10-18,10:54:07,T25
1591,C,352,16,368,2019-10-18,10:52:48,W505
1592,C,997,3,1000,2019-10-18,10:54:12,PM15
1593,C,143,33,176,2019-10-18,10:55:39,A59
1594,C,140,43,183,2019-10-18,10:50:44,BJ21
1595,C,1377,263,1640,2019-10-18,10:50:34,BJ63
1596,C,795,14,809,2019-10-18,10:54:09,PM4
1597,C,325,0,325,2019-10-18,10:54:10,PM5
1598,C,18,982,1000,2019-10-18,10:54:08,PM2
1599,C,120,100,220,2019-10-18,10:54:08,PM9
1600,C,0,21,21,2019-10-18,10:54:09,PRS1
1601,C,404,76,480,2019-10-18,10:52:24,W76
1602,C,362,26,388,2019-10-18,10:52:24,W77
1603,C,394,48,442,2019-10-18,10:52:24,W78
1604,C,355,0,355,2019-10-18,10:54:00,PM22
1605,C,301,91,392,2019-10-18,10:54:00,PR12
1606,C,82,272,354,2019-10-18,10:54:25,DWST
1607,C,261,222,483,2019-10-18,10:54:12,Y51
1608,C,289,197,486,2019-10-18,10:54:12,Y51M
1609,C,288,112,400,2019-10-18,10:54:13,Y53M
1610,C,140,108,248,2019-10-18,10:54:13,Y59M
1611,C,305,78,383,2019-10-18,10:54:14,Y60M
1612,C,279,274,553,2019-10-18,10:54:14,Y61M
1613,C,99,105,204,2019-10-18,10:54:07,T24
1614,C,163,75,238,2019-10-18,10:54:05,A7
1615,C,445,235,680,2019-10-18,10:53:53,A36
1616,C,230,73,303,2019-10-18,10:54:08,A47
1617,C,293,77,370,2019-10-18,10:52:55,PM35
1618,C,454,148,602,2019-10-18,10:54:24,P14
1619,C,69,21,90,2019-10-18,10:54:13,P15
1620,C,105,30,135,2019-10-18,10:54:02,P17
1621,C,127,123,250,2019-10-18,10:54:07,T11
1622,C,275,295,570,2019-10-18,10:54:06,T9
1623,C,0,7,7,2019-10-18,10:54:14,C21L
1624,C,7,33,40,2019-10-18,10:53:52,A51
1625,C,311,17,328,2019-10-18,10:53:52,AM19
1626,C,201,16,217,2019-10-18,10:51:45,W8M
1627,C,300,71,371,2019-10-18,10:50:41,CK14
1628,C,494,359,853,2019-10-18,10:54:30,SMM
1629,C,316,23,339,2019-10-18,10:50:49,W103
1630,C,15,6,21,2019-10-18,10:50:49,W109
1631,C,350,25,375,2019-10-18,10:52:15,W75
1632,C,357,36,393,2019-10-18,10:51:48,W53
1633,C,495,29,524,2019-10-18,10:52:06,W72
1634,C,408,32,440,2019-10-18,10:50:24,W73
1635,C,375,93,468,2019-10-18,10:54:00,T49
1636,C,101,63,164,2019-10-18,10:54:00,T49A
1637,C,643,440,1083,2019-10-18,10:53:49,PR4
1638,C,212,52,264,2019-10-18,10:54:12,TBC2
1639,C,297,104,401,2019-10-18,10:54:27,Y32
1640,C,235,68,303,2019-10-18,10:54:57,Y31
1641,C,409,91,500,2019-10-18,10:50:55,BJ19
1642,C,171,75,246,2019-10-18,10:50:52,CK15
1643,C,21,19,40,2019-10-18,10:53:52,CK6
1644,C,271,29,300,2019-10-18,10:53:53,CK6A
1645,C,21,28,49,2019-10-18,10:54:26,P11
1646,C,159,75,234,2019-10-18,10:54:27,PM46
1647,C,300,200,500,2019-10-18,10:53:54,HG1A
1648,C,123,125,248,2019-10-18,10:53:44,HG36
1649,C,90,168,258,2019-10-18,10:53:49,HG53
1650,C,20,11,31,2019-10-18,10:54:08,HG56
1651,C,174,263,437,2019-10-18,10:53:46,HG80
1652,C,453,133,586,2019-10-18,10:53:18,Y68M
1653,C,3,3,6,2019-10-18,10:53:18,Y68L
1654,C,391,59,450,2019-10-18,10:52:26,W90
1655,C,367,83,450,2019-10-18,10:52:26,W91
1656,C,271,177,448,2019-10-18,10:53:53,DRM1
1657,C,107,178,285,2019-10-18,10:53:54,DRM3
1658,C,54,50,104,2019-10-18,10:53:54,DRM4
1659,C,0,84,84,2019-10-18,10:53:55,DRM5
1660,C,1122,203,1325,2019-10-18,10:53:52,DRS
1661,C,194,41,235,2019-10-18,10:53:59,BJ20
1662,C,253,0,253,2019-10-18,10:54:00,BJ68
1663,C,192,200,392,2019-10-18,10:53:53,DRM2
1664,C,104,226,330,2019-10-18,10:54:12,TM51
1665,C,232,14,246,2019-10-18,10:52:53,W67
1666,C,92,22,114,2019-10-18,10:52:33,W717
1667,C,279,410,689,2019-10-18,10:54:18,SI13
1668,C,281,75,356,2019-10-18,10:55:13,Y63M
1669,C,361,67,428,2019-10-18,10:53:35,Y64M
1670,C,249,450,699,2019-10-18,10:55:56,A21
1671,C,161,305,466,2019-10-18,10:55:39,A29
1672,C,249,466,715,2019-10-18,10:55:37,A63
1673,C,10,34,44,2019-10-18,10:55:53,A88
1674,C,508,50,558,2019-10-18,10:52:55,SB10
1675,C,386,54,440,2019-10-18,10:54:14,SB11
1676,C,1117,142,1259,2019-10-18,10:54:05,SB13
1677,C,726,68,794,2019-10-18,10:53:46,SB12
1678,C,319,41,360,2019-10-18,10:52:35,W65
1679,C,315,25,340,2019-10-18,10:52:47,W66
1680,C,423,551,974,2019-10-18,10:54:08,T38
1681,C,345,401,746,2019-10-18,10:54:08,T39
1682,C,76,196,272,2019-10-18,10:54:08,TM41
1683,C,396,52,448,2019-10-18,10:52:46,W83
1684,C,473,26,499,2019-10-18,10:50:51,W84
1685,C,66,32,98,2019-10-18,10:50:46,CK18
1686,C,222,58,280,2019-10-18,10:54:25,SE51
1687,C,310,261,571,2019-10-18,10:54:07,HG33
1688,C,139,128,267,2019-10-18,10:55:36,A77
1689,C,239,307,546,2019-10-18,10:55:49,A78
1690,C,386,35,421,2019-10-18,10:53:25,SB7
1691,C,241,51,292,2019-10-18,10:52:54,SB8
1692,C,449,33,482,2019-10-18,10:52:31,SB9
1693,C,203,48,251,2019-10-18,10:52:58,W41
1694,C,335,51,386,2019-10-18,10:52:58,W55
1695,C,0,26,26,2019-10-18,10:54:14,Y29
1696,C,229,74,303,2019-10-18,10:54:15,BE34
1697,C,163,54,217,2019-10-18,10:54:15,BE35
1698,C,454,42,496,2019-10-18,10:52:57,Y65M
1699,C,332,75,407,2019-10-18,10:54:43,Y66M
1700,C,10678,172,10850,2019-10-18,10:50:49,BJ58
1701,C,957,537,1494,2019-10-18,10:52:57,W98
1702,C,1125,84,1209,2019-10-18,10:52:58,W61
1703,C,522,128,650,2019-10-18,10:50:55,TM47
1704,C,212,71,283,2019-10-18,10:51:02,T7A
1705,C,435,204,639,2019-10-18,10:50:47,B23M
1706,C,125,74,199,2019-10-18,10:54:19,A13
1707,C,605,2,607,2019-10-18,10:54:21,SH1
1708,C,558,296,854,2019-10-18,10:50:50,BJ50
1709,C,10949,115,11064,2019-10-18,10:50:57,BJ53
1710,C,352,273,625,2019-10-18,10:50:51,BJ54
1711,C,61,439,500,2019-10-18,10:53:50,H93L
1712,C,415,134,549,2019-10-18,10:54:07,HG93
1713,C,218,80,298,2019-10-18,10:53:52,HG98
1714,C,330,140,470,2019-10-18,10:50:32,BJ61
1715,C,578,80,658,2019-10-18,10:50:43,CKM4
1716,C,487,368,855,2019-10-18,10:50:54,CK74
1717,C,913,799,1712,2019-10-18,10:50:53,CK78
1718,C,0,5,5,2019-10-18,10:53:27,KJML
1719,L,7,23,30,2018-07-20,11:23:56,U11
1720,C,34,65,99,2019-10-18,10:54:30,C29A
1721,C,419,68,487,2019-10-18,10:54:54,CLRG
1722,C,757,133,890,2019-10-18,10:54:53,CLTR
1723,C,408,152,560,2019-10-18,10:54:13,BE18
1724,C,418,6,424,2019-10-18,10:54:14,BE44
1725,L,0,0,0,2018-06-06,16:18:33,SK34
1726,L,0,0,0,2018-06-06,16:18:33,SK35
1727,C,1261,269,1530,2019-10-18,10:54:32,GM1M
1728,C,263,74,337,2019-10-18,10:50:33,CK1
1729,L,0,0,0,2018-06-11,17:27:05,GBM
1730,L,0,0,0,2018-06-11,17:27:05,KB1
1731,C,504,101,605,2019-10-18,10:54:35,Y14
1732,C,527,128,655,2019-10-18,10:53:10,SK1
1733,C,436,224,660,2019-10-18,10:52:54,SK8
1734,C,612,99,711,2019-10-18,10:53:46,SK61
1735,C,311,49,360,2019-10-18,10:50:11,BRM7
1736,C,324,44,368,2019-10-18,10:52:06,TPMR
1737,C,0,170,170,2019-10-18,10:54:41,Y1
1738,C,129,270,399,2019-10-18,10:54:42,Y2
1739,C,296,138,434,2019-10-18,10:54:42,Y54M
1740,L,0,0,0,2018-07-01,23:10:18,SB26
1741,L,0,0,0,2018-07-01,23:10:18,SB27
1742,L,0,0,0,2018-07-01,23:10:18,SB28
1743,L,0,0,0,2018-07-01,23:10:18,S28L
1744,L,0,0,0,2018-07-01,23:26:42,PM13
1745,C,453,32,485,2019-10-18,10:53:22,UBM2
1746,C,0,6,6,2019-10-18,10:54:27,BL8L
1747,C,230,91,321,2019-10-18,10:54:17,Y30M
1748,L,0,0,0,2018-07-01,23:44:40,Y48
1749,L,0,0,0,2018-07-01,23:44:40,Y48M
1750,L,0,0,0,2018-07-01,23:07:23,SB18
1751,L,0,0,0,2018-07-01,23:07:23,SB21
1752,L,0,0,0,2018-07-01,23:43:53,Y12
1753,L,0,0,0,2018-07-01,23:44:56,Y6
1754,L,0,0,0,2018-07-01,23:45:59,Y34
1755,L,0,0,0,2018-07-01,23:45:59,Y34A
1756,L,0,0,0,2018-07-01,23:44:41,Y36
1757,L,0,0,0,2018-07-01,23:45:07,Y40
1758,L,0,0,0,2018-07-01,23:44:50,Y43
1759,L,0,0,0,2018-07-01,23:46:06,MPS
1760,L,0,0,0,2018-07-01,23:45:47,Y10
1761,L,0,0,0,2018-07-01,23:46:35,Y11
1762,L,0,0,0,2018-07-01,23:41:58,Y16
1763,L,0,0,0,2018-07-01,23:46:55,Y18
1764,L,0,0,0,2018-07-01,23:45:53,Y19
1765,L,0,0,0,2018-07-01,23:43:42,Y20
1766,L,0,0,0,2018-07-01,23:46:12,Y21
1767,L,0,0,0,2018-07-01,23:46:14,Y21M
1768,L,0,0,0,2018-07-01,23:45:50,Y26
1769,L,0,0,0,2018-07-01,23:45:31,Y27
1770,L,0,0,0,2018-07-01,23:46:16,Y28
1771,L,0,0,0,2018-07-01,23:46:16,Y28M
1772,L,0,0,0,2018-07-01,23:44:19,Y29
1773,L,0,0,0,2018-07-01,23:45:15,Y3
1774,L,0,0,0,2018-07-01,23:45:58,Y33
1775,L,0,0,0,2018-07-01,23:46:06,Y39
1776,L,0,0,0,2018-07-01,23:45:15,Y3M
1777,L,0,0,0,2018-07-01,23:46:21,Y4
1778,L,0,0,0,2018-07-01,23:46:15,Y41
1779,L,0,0,0,2018-07-01,23:46:15,Y41M
1780,L,0,0,0,2018-07-01,23:45:28,Y49
1781,L,0,0,0,2018-07-01,23:45:59,Y49L
1782,L,0,0,0,2018-07-01,23:45:59,Y49M
1783,L,0,0,0,2018-07-01,23:46:28,Y5
1784,L,0,0,0,2018-07-01,23:37:02,Y52M
1785,L,0,0,0,2018-07-01,23:44:48,Y57
1786,L,0,0,0,2018-07-01,23:45:27,Y58
1787,L,0,0,0,2018-07-01,23:40:58,Y62M
1788,L,0,0,0,2018-07-01,23:45:40,Y63M
1789,L,0,0,0,2018-07-01,23:46:06,Y64M
1790,L,0,0,0,2018-07-01,23:45:35,Y65M
1791,L,0,0,0,2018-07-01,23:37:35,Y66M
1792,L,0,0,0,2018-07-01,23:45:39,Y68L
1793,L,0,0,0,2018-07-01,23:45:39,Y68M
1794,L,0,0,0,2018-07-01,23:46:41,Y7
1795,L,0,0,0,2018-07-01,23:43:40,Y9
1796,L,0,0,0,2018-07-01,23:47:42,Y17
1797,L,0,0,0,2018-07-01,23:44:45,Y31
1798,L,0,0,0,2018-07-01,23:47:36,Y32
1799,L,0,0,0,2018-07-01,23:46:20,Y8
1800,L,0,0,0,2018-07-01,23:21:52,PM41
1801,L,0,0,0,2018-07-01,23:22:36,PM38
1802,L,0,0,0,2018-07-01,23:23:43,PM35
1803,L,0,0,0,2018-07-01,23:25:58,PM43
1804,L,0,0,0,2018-07-01,23:25:58,PM44
1805,L,0,0,0,2018-07-01,23:25:29,CV1
1806,L,0,0,0,2018-07-01,23:20:43,CV2
1807,L,0,0,0,2018-07-01,23:26:31,CV3
1808,L,0,0,0,2018-07-01,23:26:32,P40L
1809,L,0,0,0,2018-07-01,23:26:04,PM10
1810,L,0,0,0,2018-07-01,23:26:05,PM11
1811,L,0,0,0,2018-07-01,23:22:26,PM12
1812,L,0,0,0,2018-07-01,23:26:40,PM14
1813,L,0,0,0,2018-07-01,23:27:11,PM16
1814,L,0,0,0,2018-07-01,23:25:01,PM17
1815,L,0,0,0,2018-07-01,23:27:15,PM18
1816,L,0,0,0,2018-07-01,23:26:50,PM19
1817,L,0,0,0,2018-07-01,23:26:58,PM20
1818,L,0,0,0,2018-07-01,23:26:50,PM23
1819,L,0,0,0,2018-07-01,23:27:07,PM24
1820,L,0,0,0,2018-07-01,23:26:56,PM25
1821,L,0,0,0,2018-07-01,23:25:59,PM29
1822,L,0,0,0,2018-07-01,23:26:19,PM3
1823,L,0,0,0,2018-07-01,23:20:12,PM30
1824,L,0,0,0,2018-07-01,23:26:54,PM32
1825,L,0,0,0,2018-07-01,23:26:54,PM33
1826,L,0,0,0,2018-07-01,23:26:54,PM34
1827,L,0,0,0,2018-07-01,23:26:20,PM36
1828,L,0,0,0,2018-07-01,23:26:20,PM37
1829,L,0,0,0,2018-07-01,23:26:32,PM40
1830,L,0,0,0,2018-07-01,23:27:11,PM45
1831,L,0,0,0,2018-07-01,23:26:52,PM6
1832,L,0,0,0,2018-07-01,23:27:11,PM7
1833,L,0,0,0,2018-07-01,23:26:57,PM8
1834,L,0,0,0,2018-07-01,23:26:50,PR1
1835,L,0,0,0,2018-07-01,23:26:44,PR10
1836,L,0,0,0,2018-07-01,23:26:50,PR13
1837,L,0,0,0,2018-07-01,23:27:07,PR14
1838,L,0,0,0,2018-07-01,23:27:18,PR2
1839,L,0,0,0,2018-07-01,23:25:36,PR4
1840,L,0,0,0,2018-07-01,23:25:02,PR7
1841,L,0,0,0,2018-07-01,23:26:57,PR8
1842,L,0,0,0,2018-07-01,23:27:48,PM26
1843,L,0,0,0,2018-07-01,23:26:41,PM46
1844,L,0,0,0,2018-07-01,23:10:22,S19L
1845,L,0,0,0,2018-07-01,23:10:22,S24L
1846,L,0,0,0,2018-07-01,23:10:24,SB1
1847,L,0,0,0,2018-07-01,23:09:34,SB13
1848,L,0,0,0,2018-07-01,23:10:11,SB16
1849,L,0,0,0,2018-07-01,23:10:22,SB19
1850,L,0,0,0,2018-07-01,23:10:02,SB22
1851,L,0,0,0,2018-07-01,23:08:23,SB23
1852,L,0,0,0,2018-07-01,23:10:22,SB24
1853,L,0,0,0,2018-07-01,23:10:06,SB29
1854,L,0,0,0,2018-07-01,23:09:56,SB3
1855,L,0,0,0,2018-07-01,23:08:03,SB34
1856,L,0,0,0,2018-07-01,23:10:15,SB5
1857,L,0,0,0,2018-07-01,23:09:59,SB6
1858,L,0,0,0,2018-07-01,23:10:45,SB8
1859,L,0,0,0,2018-07-01,23:09:23,SB9
1860,L,0,0,0,2018-07-01,23:15:17,SB30
1861,L,0,0,0,2018-07-01,23:15:17,SB31
1862,L,0,0,0,2018-07-01,23:16:57,SB33
1863,L,0,0,0,2018-07-01,23:07:08,SB11
1864,L,0,0,0,2018-07-01,23:10:46,S15L
1865,L,0,0,0,2018-07-01,23:09:52,SB12
1866,L,0,0,0,2018-07-01,23:10:46,SB15
1867,L,0,0,0,2018-07-01,23:08:11,SB4
1868,L,0,0,0,2018-07-01,23:10:52,SB7
1869,L,0,0,0,2018-07-01,23:12:37,SB2
1870,L,0,0,0,2018-07-01,23:50:25,Y13
1871,L,0,0,0,2018-07-01,23:11:16,SB10
1872,L,0,0,0,2018-07-02,00:02:00,Y14
1873,L,0,0,0,2018-07-01,23:51:20,Y15
1874,C,549,106,655,2019-10-18,10:53:39,TPMQ
1875,C,30,37,67,2019-10-18,10:52:41,SK82
1876,C,485,123,608,2019-10-18,10:52:41,SK84
1877,C,295,66,361,2019-10-18,10:51:21,S103
1878,C,275,47,322,2019-10-18,10:53:40,SK76
1879,C,187,61,248,2019-10-18,10:52:30,SK79
1880,L,0,0,0,2018-06-29,13:58:58,BL8
1881,L,0,0,0,2018-06-29,13:58:58,BL8L
1882,C,0,26,26,2019-10-18,10:22:46,KAS
1883,C,9,70,79,2019-10-18,10:22:47,SLS
1884,L,0,0,0,2018-06-30,16:32:40,MNM
1885,L,0,0,0,2018-07-01,09:11:07,SK82
1886,L,0,0,0,2018-07-01,09:11:08,SK84
1887,C,534,24,558,2019-10-18,10:53:30,U60
1888,C,779,71,850,2019-10-18,10:53:57,U58
1889,C,136,134,270,2019-10-18,10:50:39,TW4
1890,C,230,150,380,2019-10-18,10:54:40,BE19
1891,C,0,8,8,2019-10-18,10:54:41,BE22
1892,C,520,210,730,2019-10-18,10:50:56,PL71
1893,C,270,132,402,2019-10-18,10:51:08,S107
1894,C,301,49,350,2019-10-18,10:50:32,U55
1895,C,699,57,756,2019-10-18,10:52:13,W96
1896,C,316,134,450,2019-10-18,10:53:58,W25
1897,C,146,54,200,2019-10-18,10:54:25,Y45
1898,C,379,177,556,2019-10-18,10:54:25,Y46
1899,C,0,34,34,2019-10-18,10:54:07,J47
1900,C,390,75,465,2019-10-18,10:54:26,AM43
1901,C,707,45,752,2019-10-18,10:50:37,BJ4
1902,C,666,291,957,2019-10-18,10:50:41,BJ8
1903,C,110,54,164,2019-10-18,10:50:43,CK66
1904,C,107,78,185,2019-10-18,10:54:21,J35
1905,C,2923,241,3164,2019-10-18,10:50:37,CKM5
1906,C,759,176,935,2019-10-18,10:50:34,CKM6
1907,C,129,38,167,2019-10-18,10:54:56,GM6A
1908,C,395,69,464,2019-10-18,10:54:13,SB41
1909,C,407,85,492,2019-10-18,10:54:24,W785
1910,C,449,231,680,2019-10-18,10:50:50,CK72
1911,C,865,139,1004,2019-10-18,10:53:46,U56
1912,C,349,118,467,2019-10-18,10:50:55,S109
1913,C,257,46,303,2019-10-18,10:50:46,S110
1914,C,195,165,360,2019-10-18,10:54:28,BTM3
1915,C,905,165,1070,2019-10-18,10:53:56,U57
1916,C,10520,376,10896,2019-10-18,10:50:48,CKM3
1917,C,331,59,390,2019-10-18,10:52:59,W783
1918,C,321,67,388,2019-10-18,10:54:43,TGM4
1919,C,299,51,350,2019-10-18,10:54:24,Y69M
1920,C,1022,226,1248,2019-10-18,10:54:25,Y70M
1921,C,384,39,423,2019-10-18,10:54:37,Y71M
1922,C,365,105,470,2019-10-18,10:54:40,SE9
1923,C,469,451,920,2019-10-18,10:50:57,BJ60
1924,C,240,49,289,2019-10-18,10:54:54,C15M
1925,C,360,64,424,2019-10-18,10:51:10,HG3B
1926,C,224,40,264,2019-10-18,10:50:47,HG3D
1927,C,292,83,375,2019-10-18,10:50:48,CK9A
1928,C,338,91,429,2019-10-18,10:54:10,SGTM
1929,C,0,18,18,2019-10-18,10:54:44,TPL
1930,C,168,24,192,2019-10-18,10:53:51,J5
1931,C,752,137,889,2019-10-18,10:52:37,S108
1932,C,614,201,815,2019-10-18,10:52:50,SK98
1933,C,415,59,474,2019-10-18,10:52:25,S106
1934,C,3,17,20,2019-10-18,10:50:50,BJ57
1935,C,257,76,333,2019-10-18,10:53:39,S104
1936,C,312,49,361,2019-10-18,10:53:22,S105
1937,C,547,152,699,2019-10-18,10:52:42,SK99
1938,C,120,390,510,2019-10-18,10:54:42,BM10
1939,C,39,78,117,2019-10-18,10:54:41,BM13
1940,C,402,136,538,2019-10-18,10:50:44,PL75
1941,C,384,99,483,2019-10-18,10:51:07,PL78
1942,C,285,77,362,2019-10-18,10:50:48,PL77
1943,C,266,39,305,2019-10-18,10:53:37,TJ41
1944,C,379,44,423,2019-10-18,10:54:11,J49M
1945,C,85,41,126,2019-10-18,10:50:50,TJ42
1946,C,427,74,501,2019-10-18,10:52:43,CK73
1947,C,338,44,382,2019-10-18,10:53:58,U64
1948,C,300,33,333,2019-10-18,10:54:17,W691
1949,C,251,71,322,2019-10-18,10:54:40,W693
1950,C,282,31,313,2019-10-18,10:54:41,W694
1951,C,591,128,719,2019-10-18,10:54:32,SB37
1952,C,243,30,273,2019-10-18,10:54:14,SB39
1953,C,238,41,279,2019-10-18,10:54:40,SB36
1954,C,591,75,666,2019-10-18,10:54:27,SB38
1955,C,219,44,263,2019-10-18,10:54:32,SB40
1956,C,1,1,2,2019-10-18,10:54:27,Y77L
1957,C,352,71,423,2019-10-18,10:54:26,Y77M
1958,C,182,34,216,2019-10-18,10:54:22,Y78M
1959,C,0,1,1,2019-10-18,10:54:29,A33
1960,C,482,70,552,2019-10-18,10:54:19,AM64
1961,C,858,205,1063,2019-10-18,10:53:56,S100
1962,C,304,74,378,2019-10-18,10:51:00,PL70
1963,C,319,81,400,2019-10-18,10:51:04,HG2A
1964,C,402,69,471,2019-10-18,10:50:58,HG2C
1965,C,670,81,751,2019-10-18,10:54:45,HRM
1966,C,345,53,398,2019-10-18,10:54:08,MM6
1967,C,300,146,446,2019-10-18,10:50:53,TM52
1968,C,10,22,32,2019-10-18,10:51:05,HG2D
1969,C,327,23,350,2019-10-18,10:54:04,J44
1970,C,410,42,452,2019-10-18,10:53:38,U66
1971,C,339,52,391,2019-10-18,10:53:38,U65
1972,C,314,111,425,2019-10-18,10:53:55,W182
1973,C,478,62,540,2019-10-18,10:53:55,W185
1974,C,645,117,762,2019-10-18,10:54:37,Y73M
1975,C,342,37,379,2019-10-18,10:54:38,Y74M
1976,C,327,52,379,2019-03-08,15:56:34,Y75M
1977,C,351,70,421,2019-10-18,10:54:37,Y76M
1978,C,350,45,395,2019-10-18,10:54:26,SB42
1979,C,2,1,3,2019-10-18,10:54:41,S36L
1980,C,4,4,8,2019-10-18,10:54:27,S38L
1981,C,2,2,4,2019-10-18,10:54:33,S40L
1982,C,0,85,85,2019-03-25,16:41:32,N0012
1983,C,44,26,70,2019-10-18,10:52:35,U63
1984,C,77,21,98,2019-10-18,10:51:07,B44B
1985,C,279,26,305,2019-10-18,10:54:46,C28M
1986,C,84,16,100,2019-10-18,10:51:11,TWM4
1987,C,75,160,235,2019-10-18,10:56:03,U54
1988,C,0,2,2,2019-10-18,10:54:10,J8M
1989,C,243,159,402,2019-10-18,10:55:50,Y35
1990,C,0,265,265,2019-10-18,10:55:50,W100
1991,C,107,527,634,2019-10-18,10:55:46,W546
1992,C,218,60,278,2019-10-18,10:54:50,BA1
1993,C,230,28,258,2019-10-18,10:50:48,U68
1994,C,488,61,549,2019-10-18,10:54:18,SB35
1995,C,357,110,467,2019-10-18,10:54:43,J29
1996,C,45,27,72,2019-10-18,10:55:51,J74M
1997,C,691,77,768,2019-10-18,10:50:50,NT3
1998,C,277,56,333,2019-10-18,10:50:44,TM53
1999,C,298,242,540,2019-10-18,10:50:58,T47
2000,C,152,19,171,2019-10-18,10:51:00,T47A
2001,C,997,3,1000,2019-10-18,10:54:44,TBL
2002,C,816,144,960,2019-10-18,10:54:44,TBM8
2003,Y,0,10,10,2019-10-18,10:53:54,C3ML
2004,Y,118,0,118,2019-10-18,10:38:49,KM2
2005,C,115,35,150,2019-10-18,10:55:03,BA2
2006,C,81,21,102,2019-10-18,10:52:39,K52
2007,C,385,103,488,2019-10-18,10:54:40,W574
2008,C,13,8,21,2019-10-18,10:54:26,SE52
2009,C,787,177,964,2019-10-18,10:55:56,S111
2010,C,572,198,770,2019-10-18,10:55:40,SK52
2011,C,505,253,758,2019-10-18,10:50:50,TM46
2012,C,413,47,460,2019-10-18,10:50:45,NT1
2013,C,536,54,590,2019-10-18,10:50:43,NT2
2014,C,6,21,27,2019-10-18,10:50:42,NTL
2015,Y,5,17,22,2019-10-18,10:53:52,TB1
2016,Y,15,30,45,2019-10-18,10:50:50,TB9
2017,C,0,600,600,2019-10-18,10:56:02,JS3L
2018,C,299,51,350,2019-10-18,10:56:02,SB44
2019,C,485,30,515,2019-10-18,10:50:55,NT4
2020,C,312,6,318,2019-10-18,10:54:46,DWVT
2021,C,30,19,49,2019-10-18,10:52:13,SE5L
2022,C,900,0,900,2019-10-18,10:50:45,HG18
2023,C,78,46,124,2019-10-18,10:54:50,P12
